entidadFederativa,grupoQuincenalEdad,total,Hombres,Mujeres,Anio
Estados Unidos Mexicanos,0 a 4 años,10195178,5160002,5035176,1990
Estados Unidos Mexicanos,5 a 9 años,10562234,5338285,5223949,1990
Estados Unidos Mexicanos,10 a 14 años,10389092,5230658,5158434,1990
Estados Unidos Mexicanos,15 a 19 años,9664403,4759892,4904511,1990
Estados Unidos Mexicanos,20 a 24 años,7829163,3738128,4091035,1990
Estados Unidos Mexicanos,25 a 29 años,6404512,3050595,3353917,1990
Estados Unidos Mexicanos,30 a 34 años,5387619,2578736,2808883,1990
Estados Unidos Mexicanos,35 a 39 años,4579116,2210565,2368551,1990
Estados Unidos Mexicanos,40 a 44 años,3497770,1705013,1792757,1990
Estados Unidos Mexicanos,45 a 49 años,2971860,1452573,1519287,1990
Estados Unidos Mexicanos,50 a 54 años,2393791,1161875,1231916,1990
Estados Unidos Mexicanos,55 a 59 años,1894484,918864,975620,1990
Estados Unidos Mexicanos,60 a 64 años,1611317,769917,841400,1990
Estados Unidos Mexicanos,65 a 69 años,1183651,567641,616010,1990
Estados Unidos Mexicanos,70 a 74 años,827027,394031,432996,1990
Estados Unidos Mexicanos,75 a 79 años,590836,277835,313001,1990
Estados Unidos Mexicanos,80 a 84 años,401832,179820,222012,1990
Estados Unidos Mexicanos,85 a 89 años,225450,99299,126151,1990
Estados Unidos Mexicanos,90 a 94 años,91189,38021,53168,1990
Estados Unidos Mexicanos,95 a 99 años,37689,15069,22620,1990
Estados Unidos Mexicanos,100 años y más,19167,7092,12075,1990
Estados Unidos Mexicanos,No especificado,492265,240058,252207,1990
Aguascalientes,0 a 4 años,98013,49576,48437,1990
Aguascalientes,5 a 9 años,98158,49742,48416,1990
Aguascalientes,10 a 14 años,94971,47751,47220,1990
Aguascalientes,15 a 19 años,87750,42735,45015,1990
Aguascalientes,20 a 24 años,69577,32248,37329,1990
Aguascalientes,25 a 29 años,55660,26182,29478,1990
Aguascalientes,30 a 34 años,46833,21920,24913,1990
Aguascalientes,35 a 39 años,38127,18255,19872,1990
Aguascalientes,40 a 44 años,29392,13962,15430,1990
Aguascalientes,45 a 49 años,23788,11650,12138,1990
Aguascalientes,50 a 54 años,18093,8523,9570,1990
Aguascalientes,55 a 59 años,14905,7045,7860,1990
Aguascalientes,60 a 64 años,13035,6059,6976,1990
Aguascalientes,65 a 69 años,10091,4755,5336,1990
Aguascalientes,70 a 74 años,6731,3191,3540,1990
Aguascalientes,75 a 79 años,5378,2540,2838,1990
Aguascalientes,80 a 84 años,3661,1622,2039,1990
Aguascalientes,85 a 89 años,2221,978,1243,1990
Aguascalientes,90 a 94 años,715,295,420,1990
Aguascalientes,95 a 99 años,237,81,156,1990
Aguascalientes,100 años y más,78,24,54,1990
Aguascalientes,No especificado,2245,1084,1161,1990
Baja California,0 a 4 años,202831,102769,100062,1990
Baja California,5 a 9 años,185303,94240,91063,1990
Baja California,10 a 14 años,180428,90526,89902,1990
Baja California,15 a 19 años,202116,102807,99309,1990
Baja California,20 a 24 años,184182,92536,91646,1990
Baja California,25 a 29 años,151366,75448,75918,1990
Baja California,30 a 34 años,122683,60562,62121,1990
Baja California,35 a 39 años,97317,48138,49179,1990
Baja California,40 a 44 años,71766,35438,36328,1990
Baja California,45 a 49 años,58601,29052,29549,1990
Baja California,50 a 54 años,47458,23536,23922,1990
Baja California,55 a 59 años,37179,18425,18754,1990
Baja California,60 a 64 años,30769,15152,15617,1990
Baja California,65 a 69 años,22752,11514,11238,1990
Baja California,70 a 74 años,14420,7171,7249,1990
Baja California,75 a 79 años,9438,4417,5021,1990
Baja California,80 a 84 años,5456,2350,3106,1990
Baja California,85 a 89 años,2939,1224,1715,1990
Baja California,90 a 94 años,1027,419,608,1990
Baja California,95 a 99 años,412,158,254,1990
Baja California,100 años y más,189,77,112,1990
Baja California,No especificado,32223,16131,16092,1990
Baja California Sur,0 a 4 años,38275,19453,18822,1990
Baja California Sur,5 a 9 años,38661,19802,18859,1990
Baja California Sur,10 a 14 años,38849,19717,19132,1990
Baja California Sur,15 a 19 años,37202,19008,18194,1990
Baja California Sur,20 a 24 años,32187,16219,15968,1990
Baja California Sur,25 a 29 años,28300,14015,14285,1990
Baja California Sur,30 a 34 años,24249,12152,12097,1990
Baja California Sur,35 a 39 años,19309,10012,9297,1990
Baja California Sur,40 a 44 años,14151,7344,6807,1990
Baja California Sur,45 a 49 años,11427,6016,5411,1990
Baja California Sur,50 a 54 años,8654,4570,4084,1990
Baja California Sur,55 a 59 años,6897,3680,3217,1990
Baja California Sur,60 a 64 años,5301,2730,2571,1990
Baja California Sur,65 a 69 años,3954,2068,1886,1990
Baja California Sur,70 a 74 años,2709,1374,1335,1990
Baja California Sur,75 a 79 años,1896,921,975,1990
Baja California Sur,80 a 84 años,1129,518,611,1990
Baja California Sur,85 a 89 años,698,299,399,1990
Baja California Sur,90 a 94 años,250,102,148,1990
Baja California Sur,95 a 99 años,97,33,64,1990
Baja California Sur,100 años y más,65,17,48,1990
Baja California Sur,No especificado,3504,1783,1721,1990
Campeche,0 a 4 años,71130,35835,35295,1990
Campeche,5 a 9 años,72228,36495,35733,1990
Campeche,10 a 14 años,68224,34443,33781,1990
Campeche,15 a 19 años,60846,30303,30543,1990
Campeche,20 a 24 años,49953,24470,25483,1990
Campeche,25 a 29 años,41646,20214,21432,1990
Campeche,30 a 34 años,34489,17076,17413,1990
Campeche,35 a 39 años,31017,15436,15581,1990
Campeche,40 a 44 años,22303,11216,11087,1990
Campeche,45 a 49 años,18748,9739,9009,1990
Campeche,50 a 54 años,14480,7362,7118,1990
Campeche,55 a 59 años,11782,6016,5766,1990
Campeche,60 a 64 años,10404,5481,4923,1990
Campeche,65 a 69 años,7175,3746,3429,1990
Campeche,70 a 74 años,5448,2991,2457,1990
Campeche,75 a 79 años,3362,1818,1544,1990
Campeche,80 a 84 años,2260,1259,1001,1990
Campeche,85 a 89 años,1193,621,572,1990
Campeche,90 a 94 años,529,262,267,1990
Campeche,95 a 99 años,236,123,113,1990
Campeche,100 años y más,129,53,76,1990
Campeche,No especificado,7603,3813,3790,1990
Coahuila de Zaragoza,0 a 4 años,230050,116635,113415,1990
Coahuila de Zaragoza,5 a 9 años,235925,119677,116248,1990
Coahuila de Zaragoza,10 a 14 años,251883,126837,125046,1990
Coahuila de Zaragoza,15 a 19 años,243023,121309,121714,1990
Coahuila de Zaragoza,20 a 24 años,198192,97253,100939,1990
Coahuila de Zaragoza,25 a 29 años,160430,77799,82631,1990
Coahuila de Zaragoza,30 a 34 años,136866,66375,70491,1990
Coahuila de Zaragoza,35 a 39 años,112282,55433,56849,1990
Coahuila de Zaragoza,40 a 44 años,88783,43667,45116,1990
Coahuila de Zaragoza,45 a 49 años,74867,37181,37686,1990
Coahuila de Zaragoza,50 a 54 años,61385,30195,31190,1990
Coahuila de Zaragoza,55 a 59 años,47028,23310,23718,1990
Coahuila de Zaragoza,60 a 64 años,40013,19422,20591,1990
Coahuila de Zaragoza,65 a 69 años,29448,14444,15004,1990
Coahuila de Zaragoza,70 a 74 años,19256,9409,9847,1990
Coahuila de Zaragoza,75 a 79 años,14169,6750,7419,1990
Coahuila de Zaragoza,80 a 84 años,9569,4361,5208,1990
Coahuila de Zaragoza,85 a 89 años,5085,2353,2732,1990
Coahuila de Zaragoza,90 a 94 años,1715,685,1030,1990
Coahuila de Zaragoza,95 a 99 años,633,238,395,1990
Coahuila de Zaragoza,100 años y más,277,109,168,1990
Coahuila de Zaragoza,No especificado,11461,5655,5806,1990
Colima,0 a 4 años,52269,26373,25896,1990
Colima,5 a 9 años,54412,27572,26840,1990
Colima,10 a 14 años,55609,28241,27368,1990
Colima,15 a 19 años,52837,26276,26561,1990
Colima,20 a 24 años,40023,19064,20959,1990
Colima,25 a 29 años,33413,16014,17399,1990
Colima,30 a 34 años,28739,13998,14741,1990
Colima,35 a 39 años,24122,11835,12287,1990
Colima,40 a 44 años,18372,9133,9239,1990
Colima,45 a 49 años,15453,7749,7704,1990
Colima,50 a 54 años,12009,5960,6049,1990
Colima,55 a 59 años,9293,4640,4653,1990
Colima,60 a 64 años,8057,3994,4063,1990
Colima,65 a 69 años,6631,3271,3360,1990
Colima,70 a 74 años,5054,2509,2545,1990
Colima,75 a 79 años,3497,1702,1795,1990
Colima,80 a 84 años,2222,1087,1135,1990
Colima,85 a 89 años,1246,580,666,1990
Colima,90 a 94 años,528,248,280,1990
Colima,95 a 99 años,224,91,133,1990
Colima,100 años y más,135,43,92,1990
Colima,No especificado,4365,2163,2202,1990
Chiapas,0 a 4 años,489348,246575,242773,1990
Chiapas,5 a 9 años,492534,248484,244050,1990
Chiapas,10 a 14 años,438235,222491,215744,1990
Chiapas,15 a 19 años,364776,179226,185550,1990
Chiapas,20 a 24 años,290946,140236,150710,1990
Chiapas,25 a 29 años,242845,116953,125892,1990
Chiapas,30 a 34 años,189068,93918,95150,1990
Chiapas,35 a 39 años,172594,85577,87017,1990
Chiapas,40 a 44 años,122305,61690,60615,1990
Chiapas,45 a 49 años,106102,53861,52241,1990
Chiapas,50 a 54 años,80547,41531,39016,1990
Chiapas,55 a 59 años,59003,30533,28470,1990
Chiapas,60 a 64 años,52373,27349,25024,1990
Chiapas,65 a 69 años,31946,16456,15490,1990
Chiapas,70 a 74 años,26198,13593,12605,1990
Chiapas,75 a 79 años,15980,8480,7500,1990
Chiapas,80 a 84 años,12562,6253,6309,1990
Chiapas,85 a 89 años,5934,3101,2833,1990
Chiapas,90 a 94 años,3403,1708,1695,1990
Chiapas,95 a 99 años,1578,768,810,1990
Chiapas,100 años y más,1354,662,692,1990
Chiapas,No especificado,10865,5328,5537,1990
Chihuahua,0 a 4 años,291158,147694,143464,1990
Chihuahua,5 a 9 años,285488,144750,140738,1990
Chihuahua,10 a 14 años,282115,142712,139403,1990
Chihuahua,15 a 19 años,299267,150558,148709,1990
Chihuahua,20 a 24 años,254240,125338,128902,1990
Chihuahua,25 a 29 años,205168,99585,105583,1990
Chihuahua,30 a 34 años,167343,80883,86460,1990
Chihuahua,35 a 39 años,134488,65467,69021,1990
Chihuahua,40 a 44 años,106890,52131,54759,1990
Chihuahua,45 a 49 años,94003,46202,47801,1990
Chihuahua,50 a 54 años,79277,39300,39977,1990
Chihuahua,55 a 59 años,60363,29981,30382,1990
Chihuahua,60 a 64 años,51221,25053,26168,1990
Chihuahua,65 a 69 años,36349,18043,18306,1990
Chihuahua,70 a 74 años,24255,11765,12490,1990
Chihuahua,75 a 79 años,18040,8752,9288,1990
Chihuahua,80 a 84 años,11485,5410,6075,1990
Chihuahua,85 a 89 años,5634,2508,3126,1990
Chihuahua,90 a 94 años,1969,849,1120,1990
Chihuahua,95 a 99 años,644,247,397,1990
Chihuahua,100 años y más,318,121,197,1990
Chihuahua,No especificado,32158,15953,16205,1990
Ciudad de México,0 a 4 años,833591,423599,409992,1990
Ciudad de México,5 a 9 años,837642,423802,413840,1990
Ciudad de México,10 a 14 años,837766,418552,419214,1990
Ciudad de México,15 a 19 años,976029,472392,503637,1990
Ciudad de México,20 a 24 años,898114,430901,467213,1990
Ciudad de México,25 a 29 años,778695,372514,406181,1990
Ciudad de México,30 a 34 años,659098,310444,348654,1990
Ciudad de México,35 a 39 años,544706,255606,289100,1990
Ciudad de México,40 a 44 años,417720,196228,221492,1990
Ciudad de México,45 a 49 años,338444,158036,180408,1990
Ciudad de México,50 a 54 años,274523,124635,149888,1990
Ciudad de México,55 a 59 años,223519,99161,124358,1990
Ciudad de México,60 a 64 años,192053,82016,110037,1990
Ciudad de México,65 a 69 años,145729,62266,83463,1990
Ciudad de México,70 a 74 años,95658,39526,56132,1990
Ciudad de México,75 a 79 años,70158,27810,42348,1990
Ciudad de México,80 a 84 años,44999,16597,28402,1990
Ciudad de México,85 a 89 años,25300,8537,16763,1990
Ciudad de México,90 a 94 años,9038,2745,6293,1990
Ciudad de México,95 a 99 años,3060,870,2190,1990
Ciudad de México,100 años y más,988,253,735,1990
Ciudad de México,No especificado,28914,13421,15493,1990
Durango,0 a 4 años,177249,89553,87696,1990
Durango,5 a 9 años,182860,92794,90066,1990
Durango,10 a 14 años,189988,96000,93988,1990
Durango,15 a 19 años,165463,82090,83373,1990
Durango,20 a 24 años,121376,57112,64264,1990
Durango,25 a 29 años,96432,45069,51363,1990
Durango,30 a 34 años,80561,38066,42495,1990
Durango,35 a 39 años,68315,32720,35595,1990
Durango,40 a 44 años,54334,26212,28122,1990
Durango,45 a 49 años,48644,23760,24884,1990
Durango,50 a 54 años,41529,20480,21049,1990
Durango,55 a 59 años,33821,16765,17056,1990
Durango,60 a 64 años,28239,14006,14233,1990
Durango,65 a 69 años,20214,10259,9955,1990
Durango,70 a 74 años,13507,6714,6793,1990
Durango,75 a 79 años,10397,5211,5186,1990
Durango,80 a 84 años,7515,3696,3819,1990
Durango,85 a 89 años,3908,1899,2009,1990
Durango,90 a 94 años,1468,676,792,1990
Durango,95 a 99 años,553,241,312,1990
Durango,100 años y más,208,74,134,1990
Durango,No especificado,2797,1369,1428,1990
Guanajuato,0 a 4 años,542798,274052,268746,1990
Guanajuato,5 a 9 años,552143,278071,274072,1990
Guanajuato,10 a 14 años,547837,274980,272857,1990
Guanajuato,15 a 19 años,479117,229949,249168,1990
Guanajuato,20 a 24 años,367907,166925,200982,1990
Guanajuato,25 a 29 años,285440,130966,154474,1990
Guanajuato,30 a 34 años,238296,111057,127239,1990
Guanajuato,35 a 39 años,201188,95220,105968,1990
Guanajuato,40 a 44 años,153691,73562,80129,1990
Guanajuato,45 a 49 años,129632,61931,67701,1990
Guanajuato,50 a 54 años,106186,50466,55720,1990
Guanajuato,55 a 59 años,85656,40946,44710,1990
Guanajuato,60 a 64 años,77502,36783,40719,1990
Guanajuato,65 a 69 años,55479,26561,28918,1990
Guanajuato,70 a 74 años,40520,19316,21204,1990
Guanajuato,75 a 79 años,30476,14465,16011,1990
Guanajuato,80 a 84 años,23359,10828,12531,1990
Guanajuato,85 a 89 años,13548,6292,7256,1990
Guanajuato,90 a 94 años,5367,2349,3018,1990
Guanajuato,95 a 99 años,2066,809,1257,1990
Guanajuato,100 años y más,873,280,593,1990
Guanajuato,No especificado,43512,20927,22585,1990
Guerrero,0 a 4 años,361479,182613,178866,1990
Guerrero,5 a 9 años,386810,195254,191556,1990
Guerrero,10 a 14 años,370880,187544,183336,1990
Guerrero,15 a 19 años,301872,148144,153728,1990
Guerrero,20 a 24 años,218114,101651,116463,1990
Guerrero,25 a 29 años,180524,84070,96454,1990
Guerrero,30 a 34 años,146484,69230,77254,1990
Guerrero,35 a 39 años,137436,64989,72447,1990
Guerrero,40 a 44 años,103265,49712,53553,1990
Guerrero,45 a 49 años,92617,44171,48446,1990
Guerrero,50 a 54 años,74054,35600,38454,1990
Guerrero,55 a 59 años,57775,28165,29610,1990
Guerrero,60 a 64 años,51474,24876,26598,1990
Guerrero,65 a 69 años,33936,16371,17565,1990
Guerrero,70 a 74 años,28421,13939,14482,1990
Guerrero,75 a 79 años,17170,8423,8747,1990
Guerrero,80 a 84 años,14143,6382,7761,1990
Guerrero,85 a 89 años,6721,3137,3584,1990
Guerrero,90 a 94 años,3731,1693,2038,1990
Guerrero,95 a 99 años,1556,683,873,1990
Guerrero,100 años y más,1094,428,666,1990
Guerrero,No especificado,31081,15145,15936,1990
Hidalgo,0 a 4 años,246015,124021,121994,1990
Hidalgo,5 a 9 años,269371,135688,133683,1990
Hidalgo,10 a 14 años,260049,131741,128308,1990
Hidalgo,15 a 19 años,210593,105116,105477,1990
Hidalgo,20 a 24 años,160396,75252,85144,1990
Hidalgo,25 a 29 años,137762,64262,73500,1990
Hidalgo,30 a 34 años,117480,56395,61085,1990
Hidalgo,35 a 39 años,106107,51450,54657,1990
Hidalgo,40 a 44 años,77683,38622,39061,1990
Hidalgo,45 a 49 años,70768,34915,35853,1990
Hidalgo,50 a 54 años,54437,26964,27473,1990
Hidalgo,55 a 59 años,43533,21769,21764,1990
Hidalgo,60 a 64 años,37433,18053,19380,1990
Hidalgo,65 a 69 años,28339,13645,14694,1990
Hidalgo,70 a 74 años,21014,9901,11113,1990
Hidalgo,75 a 79 años,14328,6797,7531,1990
Hidalgo,80 a 84 años,9644,4127,5517,1990
Hidalgo,85 a 89 años,5340,2254,3086,1990
Hidalgo,90 a 94 años,2384,862,1522,1990
Hidalgo,95 a 99 años,1153,409,744,1990
Hidalgo,100 años y más,728,252,476,1990
Hidalgo,No especificado,13809,6643,7166,1990
Jalisco,0 a 4 años,671649,340007,331642,1990
Jalisco,5 a 9 años,695463,352079,343384,1990
Jalisco,10 a 14 años,681667,342191,339476,1990
Jalisco,15 a 19 años,643430,311635,331795,1990
Jalisco,20 a 24 años,491687,224235,267452,1990
Jalisco,25 a 29 años,390128,179028,211100,1990
Jalisco,30 a 34 años,337131,156725,180406,1990
Jalisco,35 a 39 años,289603,136230,153373,1990
Jalisco,40 a 44 años,231557,111269,120288,1990
Jalisco,45 a 49 años,190247,92271,97976,1990
Jalisco,50 a 54 años,151319,71875,79444,1990
Jalisco,55 a 59 años,120026,56950,63076,1990
Jalisco,60 a 64 años,105816,49067,56749,1990
Jalisco,65 a 69 años,85330,40115,45215,1990
Jalisco,70 a 74 años,64662,30562,34100,1990
Jalisco,75 a 79 años,47547,22409,25138,1990
Jalisco,80 a 84 años,30814,13802,17012,1990
Jalisco,85 a 89 años,17241,7564,9677,1990
Jalisco,90 a 94 años,7097,2979,4118,1990
Jalisco,95 a 99 años,2805,1181,1624,1990
Jalisco,100 años y más,1158,462,696,1990
Jalisco,No especificado,46312,22256,24056,1990
México,0 a 4 años,1229996,622293,607703,1990
México,5 a 9 años,1284167,647646,636521,1990
México,10 a 14 años,1248189,626149,622040,1990
México,15 a 19 años,1198496,592244,606252,1990
México,20 a 24 años,1010653,488297,522356,1990
México,25 a 29 años,834509,399918,434591,1990
México,30 a 34 años,709181,341203,367978,1990
México,35 a 39 años,584990,287047,297943,1990
México,40 a 44 años,429384,213167,216217,1990
México,45 a 49 años,348862,173369,175493,1990
México,50 a 54 años,264020,129860,134160,1990
México,55 a 59 años,200166,97577,102589,1990
México,60 a 64 años,156005,73584,82421,1990
México,65 a 69 años,112907,52962,59945,1990
México,70 a 74 años,69215,31524,37691,1990
México,75 a 79 años,49615,21815,27800,1990
México,80 a 84 años,31272,12980,18292,1990
México,85 a 89 años,19588,7689,11899,1990
México,90 a 94 años,7312,2595,4717,1990
México,95 a 99 años,3497,1249,2248,1990
México,100 años y más,1510,456,1054,1990
México,No especificado,22261,10925,11336,1990
Michoacán de Ocampo,0 a 4 años,468480,236418,232062,1990
Michoacán de Ocampo,5 a 9 años,491674,248142,243532,1990
Michoacán de Ocampo,10 a 14 años,496659,249951,246708,1990
Michoacán de Ocampo,15 a 19 años,431353,206567,224786,1990
Michoacán de Ocampo,20 a 24 años,311727,139326,172401,1990
Michoacán de Ocampo,25 a 29 años,240995,110101,130894,1990
Michoacán de Ocampo,30 a 34 años,203845,95021,108824,1990
Michoacán de Ocampo,35 a 39 años,176749,84247,92502,1990
Michoacán de Ocampo,40 a 44 años,139854,67100,72754,1990
Michoacán de Ocampo,45 a 49 años,118842,56801,62041,1990
Michoacán de Ocampo,50 a 54 años,101422,48461,52961,1990
Michoacán de Ocampo,55 a 59 años,81634,39451,42183,1990
Michoacán de Ocampo,60 a 64 años,75014,35904,39110,1990
Michoacán de Ocampo,65 a 69 años,53580,25886,27694,1990
Michoacán de Ocampo,70 a 74 años,42296,20996,21300,1990
Michoacán de Ocampo,75 a 79 años,28987,14307,14680,1990
Michoacán de Ocampo,80 a 84 años,22110,10286,11824,1990
Michoacán de Ocampo,85 a 89 años,11618,5474,6144,1990
Michoacán de Ocampo,90 a 94 años,5454,2435,3019,1990
Michoacán de Ocampo,95 a 99 años,2240,952,1288,1990
Michoacán de Ocampo,100 años y más,1287,490,797,1990
Michoacán de Ocampo,No especificado,42379,20447,21932,1990
Morelos,0 a 4 años,143093,73026,70067,1990
Morelos,5 a 9 años,151548,76657,74891,1990
Morelos,10 a 14 años,153841,77268,76573,1990
Morelos,15 a 19 años,145197,70866,74331,1990
Morelos,20 a 24 años,112583,52506,60077,1990
Morelos,25 a 29 años,92584,43917,48667,1990
Morelos,30 a 34 años,80162,37720,42442,1990
Morelos,35 a 39 años,69744,33847,35897,1990
Morelos,40 a 44 años,51951,25363,26588,1990
Morelos,45 a 49 años,44861,21488,23373,1990
Morelos,50 a 54 años,36413,17358,19055,1990
Morelos,55 a 59 años,31036,14823,16213,1990
Morelos,60 a 64 años,25391,12214,13177,1990
Morelos,65 a 69 años,19143,9250,9893,1990
Morelos,70 a 74 años,11909,5750,6159,1990
Morelos,75 a 79 años,8825,4105,4720,1990
Morelos,80 a 84 años,6335,2812,3523,1990
Morelos,85 a 89 años,3888,1800,2088,1990
Morelos,90 a 94 años,1671,734,937,1990
Morelos,95 a 99 años,680,291,389,1990
Morelos,100 años y más,303,117,186,1990
Morelos,No especificado,3901,1873,2028,1990
Nayarit,0 a 4 años,103227,52490,50737,1990
Nayarit,5 a 9 años,109363,55506,53857,1990
Nayarit,10 a 14 años,112910,57093,55817,1990
Nayarit,15 a 19 años,99779,49847,49932,1990
Nayarit,20 a 24 años,70005,33394,36611,1990
Nayarit,25 a 29 años,56622,27020,29602,1990
Nayarit,30 a 34 años,49504,23882,25622,1990
Nayarit,35 a 39 años,44384,21711,22673,1990
Nayarit,40 a 44 años,34689,17253,17436,1990
Nayarit,45 a 49 años,30609,15426,15183,1990
Nayarit,50 a 54 años,25661,13038,12623,1990
Nayarit,55 a 59 años,20264,10438,9826,1990
Nayarit,60 a 64 años,17158,8686,8472,1990
Nayarit,65 a 69 años,13413,6789,6624,1990
Nayarit,70 a 74 años,10358,5268,5090,1990
Nayarit,75 a 79 años,7592,3808,3784,1990
Nayarit,80 a 84 años,4885,2400,2485,1990
Nayarit,85 a 89 años,2657,1299,1358,1990
Nayarit,90 a 94 años,1121,518,603,1990
Nayarit,95 a 99 años,465,227,238,1990
Nayarit,100 años y más,252,112,140,1990
Nayarit,No especificado,9725,4852,4873,1990
Nuevo León,0 a 4 años,331519,168597,162922,1990
Nuevo León,5 a 9 años,350558,178254,172304,1990
Nuevo León,10 a 14 años,369459,186328,183131,1990
Nuevo León,15 a 19 años,388480,195037,193443,1990
Nuevo León,20 a 24 años,337524,168514,169010,1990
Nuevo León,25 a 29 años,267335,131768,135567,1990
Nuevo León,30 a 34 años,226879,110900,115979,1990
Nuevo León,35 a 39 años,180402,88772,91630,1990
Nuevo León,40 a 44 años,145262,71411,73851,1990
Nuevo León,45 a 49 años,121838,60748,61090,1990
Nuevo León,50 a 54 años,100263,49598,50665,1990
Nuevo León,55 a 59 años,75104,36957,38147,1990
Nuevo León,60 a 64 años,62398,29546,32852,1990
Nuevo León,65 a 69 años,46095,22190,23905,1990
Nuevo León,70 a 74 años,29882,13885,15997,1990
Nuevo León,75 a 79 años,23068,10578,12490,1990
Nuevo León,80 a 84 años,14384,6381,8003,1990
Nuevo León,85 a 89 años,7963,3447,4516,1990
Nuevo León,90 a 94 años,2486,1061,1425,1990
Nuevo León,95 a 99 años,910,382,528,1990
Nuevo León,100 años y más,334,108,226,1990
Nuevo León,No especificado,16593,8202,8391,1990
Oaxaca,0 a 4 años,410741,207210,203531,1990
Oaxaca,5 a 9 años,452387,228078,224309,1990
Oaxaca,10 a 14 años,422710,214416,208294,1990
Oaxaca,15 a 19 años,324057,159459,164598,1990
Oaxaca,20 a 24 años,245537,115625,129912,1990
Oaxaca,25 a 29 años,205136,95962,109174,1990
Oaxaca,30 a 34 años,174609,82811,91798,1990
Oaxaca,35 a 39 años,158367,74828,83539,1990
Oaxaca,40 a 44 años,122750,58580,64170,1990
Oaxaca,45 a 49 años,114456,54594,59862,1990
Oaxaca,50 a 54 años,93382,44627,48755,1990
Oaxaca,55 a 59 años,77251,37064,40187,1990
Oaxaca,60 a 64 años,68702,33329,35373,1990
Oaxaca,65 a 69 años,48631,23567,25064,1990
Oaxaca,70 a 74 años,35881,17231,18650,1990
Oaxaca,75 a 79 años,24056,11640,12416,1990
Oaxaca,80 a 84 años,17595,7929,9666,1990
Oaxaca,85 a 89 años,9700,4452,5248,1990
Oaxaca,90 a 94 años,4323,1849,2474,1990
Oaxaca,95 a 99 años,1879,732,1147,1990
Oaxaca,100 años y más,1070,433,637,1990
Oaxaca,No especificado,6340,3022,3318,1990
Puebla,0 a 4 años,549465,277188,272277,1990
Puebla,5 a 9 años,587427,295554,291873,1990
Puebla,10 a 14 años,566985,284925,282060,1990
Puebla,15 a 19 años,471300,231159,240141,1990
Puebla,20 a 24 años,369823,174448,195375,1990
Puebla,25 a 29 años,295479,138847,156632,1990
Puebla,30 a 34 años,250317,118110,132207,1990
Puebla,35 a 39 años,220557,104236,116321,1990
Puebla,40 a 44 años,166092,79353,86739,1990
Puebla,45 a 49 años,148058,70806,77252,1990
Puebla,50 a 54 años,118670,56107,62563,1990
Puebla,55 a 59 años,99683,47017,52666,1990
Puebla,60 a 64 años,85006,40083,44923,1990
Puebla,65 a 69 años,63979,30069,33910,1990
Puebla,70 a 74 años,45259,21277,23982,1990
Puebla,75 a 79 años,31992,14971,17021,1990
Puebla,80 a 84 años,22198,9781,12417,1990
Puebla,85 a 89 años,13525,5853,7672,1990
Puebla,90 a 94 años,5691,2258,3433,1990
Puebla,95 a 99 años,2545,950,1595,1990
Puebla,100 años y más,1338,436,902,1990
Puebla,No especificado,10712,5103,5609,1990
Querétaro,0 a 4 años,146179,73769,72410,1990
Querétaro,5 a 9 años,149342,75103,74239,1990
Querétaro,10 a 14 años,140664,70380,70284,1990
Querétaro,15 a 19 años,125235,61191,64044,1990
Querétaro,20 a 24 años,100487,47269,53218,1990
Querétaro,25 a 29 años,81606,38944,42662,1990
Querétaro,30 a 34 años,67780,32945,34835,1990
Querétaro,35 a 39 años,55252,27222,28030,1990
Querétaro,40 a 44 años,40378,19975,20403,1990
Querétaro,45 a 49 años,33968,16788,17180,1990
Querétaro,50 a 54 años,25959,12636,13323,1990
Querétaro,55 a 59 años,21099,10276,10823,1990
Querétaro,60 a 64 años,17638,8451,9187,1990
Querétaro,65 a 69 años,13200,6350,6850,1990
Querétaro,70 a 74 años,8951,4190,4761,1990
Querétaro,75 a 79 años,6927,3161,3766,1990
Querétaro,80 a 84 años,4961,2151,2810,1990
Querétaro,85 a 89 años,2880,1297,1583,1990
Querétaro,90 a 94 años,1199,492,707,1990
Querétaro,95 a 99 años,486,186,300,1990
Querétaro,100 años y más,187,62,125,1990
Querétaro,No especificado,6857,3330,3527,1990
Quintana Roo,0 a 4 años,71097,35966,35131,1990
Quintana Roo,5 a 9 años,66069,33610,32459,1990
Quintana Roo,10 a 14 años,58780,29888,28892,1990
Quintana Roo,15 a 19 años,55940,28691,27249,1990
Quintana Roo,20 a 24 años,54226,27810,26416,1990
Quintana Roo,25 a 29 años,46170,23617,22553,1990
Quintana Roo,30 a 34 años,35950,18643,17307,1990
Quintana Roo,35 a 39 años,28267,14845,13422,1990
Quintana Roo,40 a 44 años,19006,10413,8593,1990
Quintana Roo,45 a 49 años,14626,8007,6619,1990
Quintana Roo,50 a 54 años,10415,5665,4750,1990
Quintana Roo,55 a 59 años,7518,4017,3501,1990
Quintana Roo,60 a 64 años,5735,3220,2515,1990
Quintana Roo,65 a 69 años,3980,2228,1752,1990
Quintana Roo,70 a 74 años,2724,1567,1157,1990
Quintana Roo,75 a 79 años,1607,888,719,1990
Quintana Roo,80 a 84 años,978,569,409,1990
Quintana Roo,85 a 89 años,477,254,223,1990
Quintana Roo,90 a 94 años,233,134,99,1990
Quintana Roo,95 a 99 años,111,50,61,1990
Quintana Roo,100 años y más,56,30,26,1990
Quintana Roo,No especificado,9312,4796,4516,1990
San Luis Potosí,0 a 4 años,270709,137343,133366,1990
San Luis Potosí,5 a 9 años,278401,140173,138228,1990
San Luis Potosí,10 a 14 años,271005,136540,134465,1990
San Luis Potosí,15 a 19 años,231951,115288,116663,1990
San Luis Potosí,20 a 24 años,176897,83499,93398,1990
San Luis Potosí,25 a 29 años,142709,67273,75436,1990
San Luis Potosí,30 a 34 años,119334,56953,62381,1990
San Luis Potosí,35 a 39 años,102364,49465,52899,1990
San Luis Potosí,40 a 44 años,80896,39374,41522,1990
San Luis Potosí,45 a 49 años,72233,35211,37022,1990
San Luis Potosí,50 a 54 años,61690,30305,31385,1990
San Luis Potosí,55 a 59 años,49815,24679,25136,1990
San Luis Potosí,60 a 64 años,43493,21396,22097,1990
San Luis Potosí,65 a 69 años,31872,15960,15912,1990
San Luis Potosí,70 a 74 años,20470,10187,10283,1990
San Luis Potosí,75 a 79 años,16253,8027,8226,1990
San Luis Potosí,80 a 84 años,12274,5827,6447,1990
San Luis Potosí,85 a 89 años,7510,3587,3923,1990
San Luis Potosí,90 a 94 años,2773,1259,1514,1990
San Luis Potosí,95 a 99 años,1136,475,661,1990
San Luis Potosí,100 años y más,529,174,355,1990
San Luis Potosí,No especificado,8873,4320,4553,1990
Sinaloa,0 a 4 años,268247,136016,132231,1990
Sinaloa,5 a 9 años,281174,142135,139039,1990
Sinaloa,10 a 14 años,297270,150517,146753,1990
Sinaloa,15 a 19 años,280493,140816,139677,1990
Sinaloa,20 a 24 años,208619,101847,106772,1990
Sinaloa,25 a 29 años,164727,79037,85690,1990
Sinaloa,30 a 34 años,143223,68835,74388,1990
Sinaloa,35 a 39 años,122698,60397,62301,1990
Sinaloa,40 a 44 años,96614,48726,47888,1990
Sinaloa,45 a 49 años,81853,42140,39713,1990
Sinaloa,50 a 54 años,65843,33749,32094,1990
Sinaloa,55 a 59 años,50913,26374,24539,1990
Sinaloa,60 a 64 años,41621,21257,20364,1990
Sinaloa,65 a 69 años,31281,15954,15327,1990
Sinaloa,70 a 74 años,23040,11463,11577,1990
Sinaloa,75 a 79 años,15816,7961,7855,1990
Sinaloa,80 a 84 años,9823,4547,5276,1990
Sinaloa,85 a 89 años,5042,2268,2774,1990
Sinaloa,90 a 94 años,2127,941,1186,1990
Sinaloa,95 a 99 años,868,386,482,1990
Sinaloa,100 años y más,470,182,288,1990
Sinaloa,No especificado,12292,6073,6219,1990
Sonora,0 a 4 años,213464,108387,105077,1990
Sonora,5 a 9 años,216768,109677,107091,1990
Sonora,10 a 14 años,222345,111941,110404,1990
Sonora,15 a 19 años,217889,110096,107793,1990
Sonora,20 a 24 años,181031,90097,90934,1990
Sonora,25 a 29 años,150981,73717,77264,1990
Sonora,30 a 34 años,133308,65544,67764,1990
Sonora,35 a 39 años,108248,54143,54105,1990
Sonora,40 a 44 años,82200,41561,40639,1990
Sonora,45 a 49 años,69626,35133,34493,1990
Sonora,50 a 54 años,58365,29626,28739,1990
Sonora,55 a 59 años,45439,23373,22066,1990
Sonora,60 a 64 años,36806,18600,18206,1990
Sonora,65 a 69 años,27864,14377,13487,1990
Sonora,70 a 74 años,19091,9514,9577,1990
Sonora,75 a 79 años,12855,6303,6552,1990
Sonora,80 a 84 años,7421,3433,3988,1990
Sonora,85 a 89 años,3769,1685,2084,1990
Sonora,90 a 94 años,1335,548,787,1990
Sonora,95 a 99 años,473,186,287,1990
Sonora,100 años y más,249,93,156,1990
Sonora,No especificado,14079,7054,7025,1990
Tabasco,0 a 4 años,208115,104972,103143,1990
Tabasco,5 a 9 años,216441,108915,107526,1990
Tabasco,10 a 14 años,206256,103535,102721,1990
Tabasco,15 a 19 años,176664,86746,89918,1990
Tabasco,20 a 24 años,144409,69672,74737,1990
Tabasco,25 a 29 años,121375,59055,62320,1990
Tabasco,30 a 34 años,96541,47742,48799,1990
Tabasco,35 a 39 años,84135,42114,42021,1990
Tabasco,40 a 44 años,57204,29056,28148,1990
Tabasco,45 a 49 años,48189,24496,23693,1990
Tabasco,50 a 54 años,37849,19474,18375,1990
Tabasco,55 a 59 años,29098,15182,13916,1990
Tabasco,60 a 64 años,23288,12094,11194,1990
Tabasco,65 a 69 años,15455,7991,7464,1990
Tabasco,70 a 74 años,11589,6160,5429,1990
Tabasco,75 a 79 años,7825,4093,3732,1990
Tabasco,80 a 84 años,5634,2888,2746,1990
Tabasco,85 a 89 años,3210,1667,1543,1990
Tabasco,90 a 94 años,1601,793,808,1990
Tabasco,95 a 99 años,847,411,436,1990
Tabasco,100 años y más,612,250,362,1990
Tabasco,No especificado,5407,2676,2731,1990
Tamaulipas,0 a 4 años,256810,130667,126143,1990
Tamaulipas,5 a 9 años,260284,132176,128108,1990
Tamaulipas,10 a 14 años,268815,135450,133365,1990
Tamaulipas,15 a 19 años,273793,136022,137771,1990
Tamaulipas,20 a 24 años,231171,112132,119039,1990
Tamaulipas,25 a 29 años,188111,91069,97042,1990
Tamaulipas,30 a 34 años,157309,76115,81194,1990
Tamaulipas,35 a 39 años,127147,61796,65351,1990
Tamaulipas,40 a 44 años,100806,48771,52035,1990
Tamaulipas,45 a 49 años,87714,43149,44565,1990
Tamaulipas,50 a 54 años,74561,36189,38372,1990
Tamaulipas,55 a 59 años,59066,29068,29998,1990
Tamaulipas,60 a 64 años,48780,23683,25097,1990
Tamaulipas,65 a 69 años,35940,17599,18341,1990
Tamaulipas,70 a 74 años,21998,10647,11351,1990
Tamaulipas,75 a 79 años,17318,8237,9081,1990
Tamaulipas,80 a 84 años,11754,5450,6304,1990
Tamaulipas,85 a 89 años,6873,3203,3670,1990
Tamaulipas,90 a 94 años,2163,949,1214,1990
Tamaulipas,95 a 99 años,806,324,482,1990
Tamaulipas,100 años y más,346,136,210,1990
Tamaulipas,No especificado,18016,8866,9150,1990
Tlaxcala,0 a 4 años,98004,49841,48163,1990
Tlaxcala,5 a 9 años,107483,53958,53525,1990
Tlaxcala,10 a 14 años,104575,52735,51840,1990
Tlaxcala,15 a 19 años,89788,44518,45270,1990
Tlaxcala,20 a 24 años,71689,34424,37265,1990
Tlaxcala,25 a 29 años,57606,27447,30159,1990
Tlaxcala,30 a 34 años,48100,22925,25175,1990
Tlaxcala,35 a 39 años,39473,19043,20430,1990
Tlaxcala,40 a 44 años,29399,14427,14972,1990
Tlaxcala,45 a 49 años,25549,12476,13073,1990
Tlaxcala,50 a 54 años,20869,10037,10832,1990
Tlaxcala,55 a 59 años,17599,8478,9121,1990
Tlaxcala,60 a 64 años,14949,7334,7615,1990
Tlaxcala,65 a 69 años,12043,5870,6173,1990
Tlaxcala,70 a 74 años,8284,4012,4272,1990
Tlaxcala,75 a 79 años,6354,3203,3151,1990
Tlaxcala,80 a 84 años,4143,1991,2152,1990
Tlaxcala,85 a 89 años,2832,1296,1536,1990
Tlaxcala,90 a 94 años,985,467,518,1990
Tlaxcala,95 a 99 años,530,195,335,1990
Tlaxcala,100 años y más,176,53,123,1990
Tlaxcala,No especificado,847,400,447,1990
Veracruz de Ignacio de la Llave,0 a 4 años,777420,393484,383936,1990
Veracruz de Ignacio de la Llave,5 a 9 años,821633,416819,404814,1990
Veracruz de Ignacio de la Llave,10 a 14 años,795938,401438,394500,1990
Veracruz de Ignacio de la Llave,15 a 19 años,715415,356386,359029,1990
Veracruz de Ignacio de la Llave,20 a 24 años,589326,284723,304603,1990
Veracruz de Ignacio de la Llave,25 a 29 años,485425,233676,251749,1990
Veracruz de Ignacio de la Llave,30 a 34 años,405322,195773,209549,1990
Veracruz de Ignacio de la Llave,35 a 39 años,361668,174334,187334,1990
Veracruz de Ignacio de la Llave,40 a 44 años,276466,135545,140921,1990
Veracruz de Ignacio de la Llave,45 a 49 años,240187,118069,122118,1990
Veracruz de Ignacio de la Llave,50 a 54 años,194181,95161,99020,1990
Veracruz de Ignacio de la Llave,55 a 59 años,152200,74293,77907,1990
Veracruz de Ignacio de la Llave,60 a 64 años,127548,61852,65696,1990
Veracruz de Ignacio de la Llave,65 a 69 años,90139,43691,46448,1990
Veracruz de Ignacio de la Llave,70 a 74 años,63720,30885,32835,1990
Veracruz de Ignacio de la Llave,75 a 79 años,44526,21258,23268,1990
Veracruz de Ignacio de la Llave,80 a 84 años,29753,13525,16228,1990
Veracruz de Ignacio de la Llave,85 a 89 años,16879,7679,9200,1990
Veracruz de Ignacio de la Llave,90 a 94 años,7843,3421,4422,1990
Veracruz de Ignacio de la Llave,95 a 99 años,3614,1521,2093,1990
Veracruz de Ignacio de la Llave,100 años y más,2389,925,1464,1990
Veracruz de Ignacio de la Llave,No especificado,26647,12969,13678,1990
Yucatán,0 a 4 años,170427,86107,84320,1990
Yucatán,5 a 9 años,174028,88058,85970,1990
Yucatán,10 a 14 años,169408,85649,83759,1990
Yucatán,15 a 19 años,155653,76134,79519,1990
Yucatán,20 a 24 años,121572,58580,62992,1990
Yucatán,25 a 29 años,100526,48128,52398,1990
Yucatán,30 a 34 años,86739,42043,44696,1990
Yucatán,35 a 39 años,79634,38481,41153,1990
Yucatán,40 a 44 años,64275,31759,32516,1990
Yucatán,45 a 49 años,52521,25916,26605,1990
Yucatán,50 a 54 años,42970,21001,21969,1990
Yucatán,55 a 59 años,34702,16975,17727,1990
Yucatán,60 a 64 años,30299,14800,15499,1990
Yucatán,65 a 69 años,25855,12918,12937,1990
Yucatán,70 a 74 años,20263,10390,9873,1990
Yucatán,75 a 79 años,13802,7123,6679,1990
Yucatán,80 a 84 años,8704,4298,4406,1990
Yucatán,85 a 89 años,4899,2379,2520,1990
Yucatán,90 a 94 años,1736,792,944,1990
Yucatán,95 a 99 años,655,298,357,1990
Yucatán,100 años y más,192,80,112,1990
Yucatán,No especificado,4080,1983,2097,1990
Zacatecas,0 a 4 años,172330,87473,84857,1990
Zacatecas,5 a 9 años,176489,89374,87115,1990
Zacatecas,10 a 14 años,184782,92729,92053,1990
Zacatecas,15 a 19 años,158599,77277,81322,1990
Zacatecas,20 a 24 años,114990,52525,62465,1990
Zacatecas,25 a 29 años,84807,38980,45827,1990
Zacatecas,30 a 34 años,70196,32770,37426,1990
Zacatecas,35 a 39 años,58426,27669,30757,1990
Zacatecas,40 a 44 años,48332,22993,25339,1990
Zacatecas,45 a 49 años,44527,21422,23105,1990
Zacatecas,50 a 54 años,37307,17986,19321,1990
Zacatecas,55 a 59 años,31117,15436,15681,1990
Zacatecas,60 a 64 años,27796,13843,13953,1990
Zacatecas,65 a 69 años,20901,10476,10425,1990
Zacatecas,70 a 74 años,14244,7124,7120,1990
Zacatecas,75 a 79 años,11582,5862,5720,1990
Zacatecas,80 a 84 años,8790,4280,4510,1990
Zacatecas,85 a 89 años,5132,2623,2509,1990
Zacatecas,90 a 94 años,1915,903,1012,1990
Zacatecas,95 a 99 años,693,322,371,1990
Zacatecas,100 años y más,273,100,173,1990
Zacatecas,No especificado,3095,1496,1599,1990
Estados Unidos Mexicanos,0 a 4 años,10724100,5449356,5274744,1995
Estados Unidos Mexicanos,5 a 9 años,10867563,5515644,5351919,1995
Estados Unidos Mexicanos,10 a 14 años,10670048,5404261,5265787,1995
Estados Unidos Mexicanos,15 a 19 años,10142071,5022243,5119828,1995
Estados Unidos Mexicanos,20 a 24 años,9397424,4538686,4858738,1995
Estados Unidos Mexicanos,25 a 29 años,7613090,3652995,3960095,1995
Estados Unidos Mexicanos,30 a 34 años,6564605,3152462,3412143,1995
Estados Unidos Mexicanos,35 a 39 años,5820178,2804296,3015882,1995
Estados Unidos Mexicanos,40 a 44 años,4434317,2173041,2261276,1995
Estados Unidos Mexicanos,45 a 49 años,3612452,1763505,1848947,1995
Estados Unidos Mexicanos,50 a 54 años,2896049,1418508,1477541,1995
Estados Unidos Mexicanos,55 a 59 años,2231897,1083293,1148604,1995
Estados Unidos Mexicanos,60 a 64 años,1941953,929650,1012303,1995
Estados Unidos Mexicanos,65 a 69 años,1425809,674004,751805,1995
Estados Unidos Mexicanos,70 a 74 años,1079803,521069,558734,1995
Estados Unidos Mexicanos,75 a 79 años,666196,317553,348643,1995
Estados Unidos Mexicanos,80 a 84 años,434120,193923,240197,1995
Estados Unidos Mexicanos,85 a 89 años,252802,112158,140644,1995
Estados Unidos Mexicanos,90 a 94 años,105150,44789,60361,1995
Estados Unidos Mexicanos,95 a 99 años,49764,20716,29048,1995
Estados Unidos Mexicanos,100 años y más,14046,5137,8909,1995
Estados Unidos Mexicanos,No especificado,214853,103210,111643,1995
Aguascalientes,0 a 4 años,112429,56920,55509,1995
Aguascalientes,5 a 9 años,107680,54663,53017,1995
Aguascalientes,10 a 14 años,104083,52977,51106,1995
Aguascalientes,15 a 19 años,97061,48025,49036,1995
Aguascalientes,20 a 24 años,88901,42402,46499,1995
Aguascalientes,25 a 29 años,71839,33658,38181,1995
Aguascalientes,30 a 34 años,62217,29478,32739,1995
Aguascalientes,35 a 39 años,52549,25116,27433,1995
Aguascalientes,40 a 44 años,40131,19467,20664,1995
Aguascalientes,45 a 49 años,31678,15260,16418,1995
Aguascalientes,50 a 54 años,24525,11930,12595,1995
Aguascalientes,55 a 59 años,17646,8436,9210,1995
Aguascalientes,60 a 64 años,15900,7378,8522,1995
Aguascalientes,65 a 69 años,11870,5412,6458,1995
Aguascalientes,70 a 74 años,9452,4438,5014,1995
Aguascalientes,75 a 79 años,5771,2738,3033,1995
Aguascalientes,80 a 84 años,3892,1776,2116,1995
Aguascalientes,85 a 89 años,2428,1063,1365,1995
Aguascalientes,90 a 94 años,975,409,566,1995
Aguascalientes,95 a 99 años,380,154,226,1995
Aguascalientes,100 años y más,59,17,42,1995
Aguascalientes,No especificado,1254,607,647,1995
Baja California,0 a 4 años,257856,131186,126670,1995
Baja California,5 a 9 años,238928,121542,117386,1995
Baja California,10 a 14 años,208902,106410,102492,1995
Baja California,15 a 19 años,215142,108162,106980,1995
Baja California,20 a 24 años,240052,121008,119044,1995
Baja California,25 a 29 años,208348,105757,102591,1995
Baja California,30 a 34 años,175151,88797,86354,1995
Baja California,35 a 39 años,143144,71708,71436,1995
Baja California,40 a 44 años,105499,52968,52531,1995
Baja California,45 a 49 años,80606,39883,40723,1995
Baja California,50 a 54 años,64059,31978,32081,1995
Baja California,55 a 59 años,47838,23550,24288,1995
Baja California,60 a 64 años,40558,19816,20742,1995
Baja California,65 a 69 años,29724,14528,15196,1995
Baja California,70 a 74 años,21048,10598,10450,1995
Baja California,75 a 79 años,12270,6068,6202,1995
Baja California,80 a 84 años,7248,3211,4037,1995
Baja California,85 a 89 años,3702,1516,2186,1995
Baja California,90 a 94 años,1336,530,806,1995
Baja California,95 a 99 años,572,228,344,1995
Baja California,100 años y más,141,49,92,1995
Baja California,No especificado,10016,5098,4918,1995
Baja California Sur,0 a 4 años,42732,21829,20903,1995
Baja California Sur,5 a 9 años,42977,21914,21063,1995
Baja California Sur,10 a 14 años,41165,21139,20026,1995
Baja California Sur,15 a 19 años,40586,20591,19995,1995
Baja California Sur,20 a 24 años,39231,19607,19624,1995
Baja California Sur,25 a 29 años,34454,17321,17133,1995
Baja California Sur,30 a 34 años,30976,15373,15603,1995
Baja California Sur,35 a 39 años,26784,13577,13207,1995
Baja California Sur,40 a 44 años,19764,10270,9494,1995
Baja California Sur,45 a 49 años,14905,7786,7119,1995
Baja California Sur,50 a 54 años,11611,6110,5501,1995
Baja California Sur,55 a 59 años,8618,4574,4044,1995
Baja California Sur,60 a 64 años,6868,3545,3323,1995
Baja California Sur,65 a 69 años,5061,2574,2487,1995
Baja California Sur,70 a 74 años,3560,1870,1690,1995
Baja California Sur,75 a 79 años,2353,1140,1213,1995
Baja California Sur,80 a 84 años,1430,657,773,1995
Baja California Sur,85 a 89 años,795,355,440,1995
Baja California Sur,90 a 94 años,321,131,190,1995
Baja California Sur,95 a 99 años,149,46,103,1995
Baja California Sur,100 años y más,35,13,22,1995
Baja California Sur,No especificado,1119,591,528,1995
Campeche,0 a 4 años,80026,40710,39316,1995
Campeche,5 a 9 años,80680,40787,39893,1995
Campeche,10 a 14 años,77875,39434,38441,1995
Campeche,15 a 19 años,71464,35725,35739,1995
Campeche,20 a 24 años,64693,31663,33030,1995
Campeche,25 a 29 años,52129,25406,26723,1995
Campeche,30 a 34 años,45219,22241,22978,1995
Campeche,35 a 39 años,40558,20102,20456,1995
Campeche,40 a 44 años,30851,15718,15133,1995
Campeche,45 a 49 años,24521,12510,12011,1995
Campeche,50 a 54 años,18502,9543,8959,1995
Campeche,55 a 59 años,14680,7439,7241,1995
Campeche,60 a 64 años,12842,6619,6223,1995
Campeche,65 a 69 años,9347,4867,4480,1995
Campeche,70 a 74 años,7362,3982,3380,1995
Campeche,75 a 79 años,4504,2443,2061,1995
Campeche,80 a 84 años,2674,1408,1266,1995
Campeche,85 a 89 años,1449,766,683,1995
Campeche,90 a 94 años,682,363,319,1995
Campeche,95 a 99 años,304,162,142,1995
Campeche,100 años y más,125,57,68,1995
Campeche,No especificado,2029,1046,983,1995
Coahuila de Zaragoza,0 a 4 años,253150,128620,124530,1995
Coahuila de Zaragoza,5 a 9 años,241326,122663,118663,1995
Coahuila de Zaragoza,10 a 14 años,236394,119915,116479,1995
Coahuila de Zaragoza,15 a 19 años,240739,120684,120055,1995
Coahuila de Zaragoza,20 a 24 años,231564,113983,117581,1995
Coahuila de Zaragoza,25 a 29 años,187979,91537,96442,1995
Coahuila de Zaragoza,30 a 34 años,164412,79968,84444,1995
Coahuila de Zaragoza,35 a 39 años,143230,69986,73244,1995
Coahuila de Zaragoza,40 a 44 años,109439,54275,55164,1995
Coahuila de Zaragoza,45 a 49 años,90101,44548,45553,1995
Coahuila de Zaragoza,50 a 54 años,72230,35823,36407,1995
Coahuila de Zaragoza,55 a 59 años,56802,28056,28746,1995
Coahuila de Zaragoza,60 a 64 años,47416,23213,24203,1995
Coahuila de Zaragoza,65 a 69 años,35309,16920,18389,1995
Coahuila de Zaragoza,70 a 74 años,25443,12520,12923,1995
Coahuila de Zaragoza,75 a 79 años,15572,7592,7980,1995
Coahuila de Zaragoza,80 a 84 años,9618,4404,5214,1995
Coahuila de Zaragoza,85 a 89 años,5983,2610,3373,1995
Coahuila de Zaragoza,90 a 94 años,2044,904,1140,1995
Coahuila de Zaragoza,95 a 99 años,873,370,503,1995
Coahuila de Zaragoza,100 años y más,169,66,103,1995
Coahuila de Zaragoza,No especificado,3982,1937,2045,1995
Colima,0 a 4 años,54512,28006,26506,1995
Colima,5 a 9 años,57304,29014,28290,1995
Colima,10 a 14 años,57444,29269,28175,1995
Colima,15 a 19 años,55665,27879,27786,1995
Colima,20 a 24 años,50183,24385,25798,1995
Colima,25 a 29 años,39747,18987,20760,1995
Colima,30 a 34 años,35694,17201,18493,1995
Colima,35 a 39 años,32099,15693,16406,1995
Colima,40 a 44 años,24674,12314,12360,1995
Colima,45 a 49 años,19427,9797,9630,1995
Colima,50 a 54 años,15550,7739,7811,1995
Colima,55 a 59 años,11815,5949,5866,1995
Colima,60 a 64 años,9813,4778,5035,1995
Colima,65 a 69 años,7519,3722,3797,1995
Colima,70 a 74 años,6251,3167,3084,1995
Colima,75 a 79 años,4261,2092,2169,1995
Colima,80 a 84 años,2778,1289,1489,1995
Colima,85 a 89 años,1551,740,811,1995
Colima,90 a 94 años,659,292,367,1995
Colima,95 a 99 años,335,138,197,1995
Colima,100 años y más,74,34,40,1995
Colima,No especificado,673,302,371,1995
Chiapas,0 a 4 años,501668,253905,247763,1995
Chiapas,5 a 9 años,509161,257540,251621,1995
Chiapas,10 a 14 años,473016,239795,233221,1995
Chiapas,15 a 19 años,417806,206179,211627,1995
Chiapas,20 a 24 años,339774,163857,175917,1995
Chiapas,25 a 29 años,273873,131357,142516,1995
Chiapas,30 a 34 años,222885,109684,113201,1995
Chiapas,35 a 39 años,207954,102135,105819,1995
Chiapas,40 a 44 años,151151,76939,74212,1995
Chiapas,45 a 49 años,124169,62898,61271,1995
Chiapas,50 a 54 años,96273,49650,46623,1995
Chiapas,55 a 59 años,71025,36280,34745,1995
Chiapas,60 a 64 años,61519,31695,29824,1995
Chiapas,65 a 69 años,40548,20533,20015,1995
Chiapas,70 a 74 años,31734,16544,15190,1995
Chiapas,75 a 79 años,18589,9796,8793,1995
Chiapas,80 a 84 años,13071,6495,6576,1995
Chiapas,85 a 89 años,6412,3299,3113,1995
Chiapas,90 a 94 años,3612,1833,1779,1995
Chiapas,95 a 99 años,1848,908,940,1995
Chiapas,100 años y más,1074,539,535,1995
Chiapas,No especificado,17624,8719,8905,1995
Chihuahua,0 a 4 años,330996,168403,162593,1995
Chihuahua,5 a 9 años,320170,162991,157179,1995
Chihuahua,10 a 14 años,293173,149003,144170,1995
Chihuahua,15 a 19 años,291853,146786,145067,1995
Chihuahua,20 a 24 años,299966,148984,150982,1995
Chihuahua,25 a 29 años,254432,125406,129026,1995
Chihuahua,30 a 34 años,216249,106152,110097,1995
Chihuahua,35 a 39 años,181098,88099,92999,1995
Chihuahua,40 a 44 años,134678,66021,68657,1995
Chihuahua,45 a 49 años,110031,53545,56486,1995
Chihuahua,50 a 54 años,93325,45975,47350,1995
Chihuahua,55 a 59 años,74656,36676,37980,1995
Chihuahua,60 a 64 años,63150,31027,32123,1995
Chihuahua,65 a 69 años,45828,22185,23643,1995
Chihuahua,70 a 74 años,32628,16266,16362,1995
Chihuahua,75 a 79 años,19503,9418,10085,1995
Chihuahua,80 a 84 años,12527,5836,6691,1995
Chihuahua,85 a 89 años,7069,3174,3895,1995
Chihuahua,90 a 94 años,2387,1033,1354,1995
Chihuahua,95 a 99 años,988,428,560,1995
Chihuahua,100 años y más,218,90,128,1995
Chihuahua,No especificado,8612,4416,4196,1995
Ciudad de México,0 a 4 años,780705,397471,383234,1995
Ciudad de México,5 a 9 años,785466,399659,385807,1995
Ciudad de México,10 a 14 años,781808,394202,387606,1995
Ciudad de México,15 a 19 años,848416,412443,435973,1995
Ciudad de México,20 a 24 años,964075,464586,499489,1995
Ciudad de México,25 a 29 años,826960,398800,428160,1995
Ciudad de México,30 a 34 años,725263,343863,381400,1995
Ciudad de México,35 a 39 años,643428,303002,340426,1995
Ciudad de México,40 a 44 años,499935,236398,263537,1995
Ciudad de México,45 a 49 años,402093,188011,214082,1995
Ciudad de México,50 a 54 años,325253,151341,173912,1995
Ciudad de México,55 a 59 años,235829,106781,129048,1995
Ciudad de México,60 a 64 años,212782,92245,120537,1995
Ciudad de México,65 a 69 años,158713,66784,91929,1995
Ciudad de México,70 a 74 años,119920,50741,69179,1995
Ciudad de México,75 a 79 años,71291,29171,42120,1995
Ciudad de México,80 a 84 años,46687,17256,29431,1995
Ciudad de México,85 a 89 años,26414,9414,17000,1995
Ciudad de México,90 a 94 años,10508,3492,7016,1995
Ciudad de México,95 a 99 años,4126,1269,2857,1995
Ciudad de México,100 años y más,685,186,499,1995
Ciudad de México,No especificado,18650,8787,9863,1995
Durango,0 a 4 años,175246,89065,86181,1995
Durango,5 a 9 años,180229,91542,88687,1995
Durango,10 a 14 años,175910,89312,86598,1995
Durango,15 a 19 años,165403,83030,82373,1995
Durango,20 a 24 años,140244,68068,72176,1995
Durango,25 a 29 años,109163,51815,57348,1995
Durango,30 a 34 años,95654,45515,50139,1995
Durango,35 a 39 años,83865,40309,43556,1995
Durango,40 a 44 años,64382,31247,33135,1995
Durango,45 a 49 años,54268,26415,27853,1995
Durango,50 a 54 años,45710,22699,23011,1995
Durango,55 a 59 años,37306,18511,18795,1995
Durango,60 a 64 años,33863,16789,17074,1995
Durango,65 a 69 años,24605,12220,12385,1995
Durango,70 a 74 años,17811,9022,8789,1995
Durango,75 a 79 años,10563,5306,5257,1995
Durango,80 a 84 años,7168,3453,3715,1995
Durango,85 a 89 años,4640,2213,2427,1995
Durango,90 a 94 años,1612,762,850,1995
Durango,95 a 99 años,692,303,389,1995
Durango,100 años y más,189,59,130,1995
Durango,No especificado,3225,1613,1612,1995
Guanajuato,0 a 4 años,561702,284585,277117,1995
Guanajuato,5 a 9 años,561618,284373,277245,1995
Guanajuato,10 a 14 años,557242,280314,276928,1995
Guanajuato,15 a 19 años,513332,248784,264548,1995
Guanajuato,20 a 24 años,443945,204358,239587,1995
Guanajuato,25 a 29 años,345170,159824,185346,1995
Guanajuato,30 a 34 años,292316,136510,155806,1995
Guanajuato,35 a 39 años,255552,121364,134188,1995
Guanajuato,40 a 44 años,196209,94705,101504,1995
Guanajuato,45 a 49 años,157073,75860,81213,1995
Guanajuato,50 a 54 años,127784,61421,66363,1995
Guanajuato,55 a 59 años,96922,46387,50535,1995
Guanajuato,60 a 64 años,90404,42947,47457,1995
Guanajuato,65 a 69 años,67006,31703,35303,1995
Guanajuato,70 a 74 años,53790,26018,27772,1995
Guanajuato,75 a 79 años,31365,14860,16505,1995
Guanajuato,80 a 84 años,23999,10900,13099,1995
Guanajuato,85 a 89 años,14196,6651,7545,1995
Guanajuato,90 a 94 años,6241,2787,3454,1995
Guanajuato,95 a 99 años,2681,1132,1549,1995
Guanajuato,100 años y más,551,174,377,1995
Guanajuato,No especificado,7470,3447,4023,1995
Guerrero,0 a 4 años,388050,197290,190760,1995
Guerrero,5 a 9 años,399798,202850,196948,1995
Guerrero,10 a 14 años,387415,196670,190745,1995
Guerrero,15 a 19 años,336443,166520,169923,1995
Guerrero,20 a 24 años,265340,126456,138884,1995
Guerrero,25 a 29 años,205582,96854,108728,1995
Guerrero,30 a 34 años,177944,84143,93801,1995
Guerrero,35 a 39 años,165407,78286,87121,1995
Guerrero,40 a 44 años,126571,61736,64835,1995
Guerrero,45 a 49 años,106096,51070,55026,1995
Guerrero,50 a 54 años,86328,41907,44421,1995
Guerrero,55 a 59 años,67228,32323,34905,1995
Guerrero,60 a 64 años,63816,30678,33138,1995
Guerrero,65 a 69 años,42877,20447,22430,1995
Guerrero,70 a 74 años,35686,17264,18422,1995
Guerrero,75 a 79 años,20694,10275,10419,1995
Guerrero,80 a 84 años,14734,6795,7939,1995
Guerrero,85 a 89 años,7581,3613,3968,1995
Guerrero,90 a 94 años,3822,1675,2147,1995
Guerrero,95 a 99 años,2028,911,1117,1995
Guerrero,100 años y más,894,360,534,1995
Guerrero,No especificado,12233,5294,6939,1995
Hidalgo,0 a 4 años,252617,128449,124168,1995
Hidalgo,5 a 9 años,265590,134122,131468,1995
Hidalgo,10 a 14 años,269753,136420,133333,1995
Hidalgo,15 a 19 años,239592,119944,119648,1995
Hidalgo,20 a 24 años,201620,96765,104855,1995
Hidalgo,25 a 29 años,162352,77241,85111,1995
Hidalgo,30 a 34 años,141617,67019,74598,1995
Hidalgo,35 a 39 años,132294,63858,68436,1995
Hidalgo,40 a 44 años,98208,49155,49053,1995
Hidalgo,45 a 49 años,83345,41453,41892,1995
Hidalgo,50 a 54 años,65824,32702,33122,1995
Hidalgo,55 a 59 años,51647,25527,26120,1995
Hidalgo,60 a 64 años,44554,21660,22894,1995
Hidalgo,65 a 69 años,33606,16024,17582,1995
Hidalgo,70 a 74 años,26160,12722,13438,1995
Hidalgo,75 a 79 años,17386,8437,8949,1995
Hidalgo,80 a 84 años,10546,4619,5927,1995
Hidalgo,85 a 89 años,6056,2564,3492,1995
Hidalgo,90 a 94 años,2712,1043,1669,1995
Hidalgo,95 a 99 años,1473,557,916,1995
Hidalgo,100 años y más,514,148,366,1995
Hidalgo,No especificado,5007,2137,2870,1995
Jalisco,0 a 4 años,701617,356974,344643,1995
Jalisco,5 a 9 años,717968,364579,353389,1995
Jalisco,10 a 14 años,715201,362767,352434,1995
Jalisco,15 a 19 años,676896,333050,343846,1995
Jalisco,20 a 24 años,615402,291850,323552,1995
Jalisco,25 a 29 años,482529,225997,256532,1995
Jalisco,30 a 34 años,413098,193534,219564,1995
Jalisco,35 a 39 años,365641,173020,192621,1995
Jalisco,40 a 44 años,291118,139687,151431,1995
Jalisco,45 a 49 años,237708,115217,122491,1995
Jalisco,50 a 54 años,192416,93304,99112,1995
Jalisco,55 a 59 años,143341,68852,74489,1995
Jalisco,60 a 64 años,125183,58712,66471,1995
Jalisco,65 a 69 años,95384,44832,50552,1995
Jalisco,70 a 74 años,79247,37374,41873,1995
Jalisco,75 a 79 años,53066,25061,28005,1995
Jalisco,80 a 84 años,36385,16501,19884,1995
Jalisco,85 a 89 años,19954,8852,11102,1995
Jalisco,90 a 94 años,8299,3529,4770,1995
Jalisco,95 a 99 años,3510,1477,2033,1995
Jalisco,100 años y más,820,288,532,1995
Jalisco,No especificado,16393,8464,7929,1995
México,0 a 4 años,1364484,692929,671555,1995
México,5 a 9 años,1382651,701280,681371,1995
México,10 a 14 años,1344420,678340,666080,1995
México,15 a 19 años,1305765,648259,657506,1995
México,20 a 24 años,1295228,629684,665544,1995
México,25 a 29 años,1058142,511944,546198,1995
México,30 a 34 años,913299,439328,473971,1995
México,35 a 39 años,793800,384902,408898,1995
México,40 a 44 años,586683,290564,296119,1995
México,45 a 49 años,457065,225645,231420,1995
México,50 a 54 años,349220,172646,176574,1995
México,55 a 59 años,251155,122363,128792,1995
México,60 a 64 años,204472,96996,107476,1995
México,65 a 69 años,145024,67125,77899,1995
México,70 a 74 años,101342,47057,54285,1995
México,75 a 79 años,59674,27032,32642,1995
México,80 a 84 años,34930,14403,20527,1995
México,85 a 89 años,21492,8568,12924,1995
México,90 a 94 años,8673,3229,5444,1995
México,95 a 99 años,4715,1668,3047,1995
México,100 años y más,1000,259,741,1995
México,No especificado,24730,11833,12897,1995
Michoacán de Ocampo,0 a 4 años,467147,236928,230219,1995
Michoacán de Ocampo,5 a 9 años,499020,252636,246384,1995
Michoacán de Ocampo,10 a 14 años,501490,253564,247926,1995
Michoacán de Ocampo,15 a 19 años,457894,222492,235402,1995
Michoacán de Ocampo,20 a 24 años,370671,171442,199229,1995
Michoacán de Ocampo,25 a 29 años,281231,128989,152242,1995
Michoacán de Ocampo,30 a 34 años,244357,114243,130114,1995
Michoacán de Ocampo,35 a 39 años,221033,104658,116375,1995
Michoacán de Ocampo,40 a 44 años,173986,84892,89094,1995
Michoacán de Ocampo,45 a 49 años,141762,68441,73321,1995
Michoacán de Ocampo,50 a 54 años,118272,56873,61399,1995
Michoacán de Ocampo,55 a 59 años,91798,43955,47843,1995
Michoacán de Ocampo,60 a 64 años,88981,42632,46349,1995
Michoacán de Ocampo,65 a 69 años,65207,30972,34235,1995
Michoacán de Ocampo,70 a 74 años,54355,26750,27605,1995
Michoacán de Ocampo,75 a 79 años,32765,16287,16478,1995
Michoacán de Ocampo,80 a 84 años,23993,11300,12693,1995
Michoacán de Ocampo,85 a 89 años,13194,6283,6911,1995
Michoacán de Ocampo,90 a 94 años,5932,2663,3269,1995
Michoacán de Ocampo,95 a 99 años,2925,1289,1636,1995
Michoacán de Ocampo,100 años y más,931,367,564,1995
Michoacán de Ocampo,No especificado,13660,6449,7211,1995
Morelos,0 a 4 años,167226,85141,82085,1995
Morelos,5 a 9 años,166248,84621,81627,1995
Morelos,10 a 14 años,166885,84508,82377,1995
Morelos,15 a 19 años,161301,79242,82059,1995
Morelos,20 a 24 años,147558,69809,77749,1995
Morelos,25 a 29 años,117551,55332,62219,1995
Morelos,30 a 34 años,103465,48938,54527,1995
Morelos,35 a 39 años,95595,45429,50166,1995
Morelos,40 a 44 años,72003,35431,36572,1995
Morelos,45 a 49 años,58154,28428,29726,1995
Morelos,50 a 54 años,46219,22458,23761,1995
Morelos,55 a 59 años,36749,17581,19168,1995
Morelos,60 a 64 años,33014,15730,17284,1995
Morelos,65 a 69 años,25504,11976,13528,1995
Morelos,70 a 74 años,18175,8942,9233,1995
Morelos,75 a 79 años,10844,5315,5529,1995
Morelos,80 a 84 años,6555,2937,3618,1995
Morelos,85 a 89 años,4469,1979,2490,1995
Morelos,90 a 94 años,1918,851,1067,1995
Morelos,95 a 99 años,1076,477,599,1995
Morelos,100 años y más,251,79,172,1995
Morelos,No especificado,1902,877,1025,1995
Nayarit,0 a 4 años,103803,52853,50950,1995
Nayarit,5 a 9 años,110505,56418,54087,1995
Nayarit,10 a 14 años,110790,56474,54316,1995
Nayarit,15 a 19 años,102913,51622,51291,1995
Nayarit,20 a 24 años,86384,42502,43882,1995
Nayarit,25 a 29 años,66502,32220,34282,1995
Nayarit,30 a 34 años,58527,28236,30291,1995
Nayarit,35 a 39 años,53925,25900,28025,1995
Nayarit,40 a 44 años,43229,21563,21666,1995
Nayarit,45 a 49 años,35862,18025,17837,1995
Nayarit,50 a 54 años,29721,15068,14653,1995
Nayarit,55 a 59 años,24833,12653,12180,1995
Nayarit,60 a 64 años,20521,10438,10083,1995
Nayarit,65 a 69 años,16025,8081,7944,1995
Nayarit,70 a 74 años,12263,6325,5938,1995
Nayarit,75 a 79 años,8483,4274,4209,1995
Nayarit,80 a 84 años,5638,2708,2930,1995
Nayarit,85 a 89 años,3085,1483,1602,1995
Nayarit,90 a 94 años,1252,601,651,1995
Nayarit,95 a 99 años,633,309,324,1995
Nayarit,100 años y más,156,71,85,1995
Nayarit,No especificado,1652,805,847,1995
Nuevo León,0 a 4 años,372590,190224,182366,1995
Nuevo León,5 a 9 años,360813,183897,176916,1995
Nuevo León,10 a 14 años,360951,183492,177459,1995
Nuevo León,15 a 19 años,390485,195644,194841,1995
Nuevo León,20 a 24 años,412575,207929,204646,1995
Nuevo León,25 a 29 años,336502,166536,169966,1995
Nuevo León,30 a 34 años,283907,140426,143481,1995
Nuevo León,35 a 39 años,243192,120187,123005,1995
Nuevo León,40 a 44 años,183087,90621,92466,1995
Nuevo León,45 a 49 años,151856,75209,76647,1995
Nuevo León,50 a 54 años,122905,60893,62012,1995
Nuevo León,55 a 59 años,96263,47706,48557,1995
Nuevo León,60 a 64 años,77359,37553,39806,1995
Nuevo León,65 a 69 años,57318,27042,30276,1995
Nuevo León,70 a 74 años,41030,19660,21370,1995
Nuevo León,75 a 79 años,25120,11677,13443,1995
Nuevo León,80 a 84 años,16178,7040,9138,1995
Nuevo León,85 a 89 años,9406,4059,5347,1995
Nuevo León,90 a 94 años,3497,1475,2022,1995
Nuevo León,95 a 99 años,1256,538,718,1995
Nuevo León,100 años y más,267,96,171,1995
Nuevo León,No especificado,3557,1889,1668,1995
Oaxaca,0 a 4 años,402105,203558,198547,1995
Oaxaca,5 a 9 años,436486,220830,215656,1995
Oaxaca,10 a 14 años,434282,220899,213383,1995
Oaxaca,15 a 19 años,358526,178098,180428,1995
Oaxaca,20 a 24 años,281574,133575,147999,1995
Oaxaca,25 a 29 años,223026,104693,118333,1995
Oaxaca,30 a 34 años,198336,94093,104243,1995
Oaxaca,35 a 39 años,183926,86730,97196,1995
Oaxaca,40 a 44 años,143539,69431,74108,1995
Oaxaca,45 a 49 años,123361,58894,64467,1995
Oaxaca,50 a 54 años,103778,49639,54139,1995
Oaxaca,55 a 59 años,83816,39984,43832,1995
Oaxaca,60 a 64 años,78424,37683,40741,1995
Oaxaca,65 a 69 años,55762,26632,29130,1995
Oaxaca,70 a 74 años,43471,21251,22220,1995
Oaxaca,75 a 79 años,28012,13617,14395,1995
Oaxaca,80 a 84 años,18426,8419,10007,1995
Oaxaca,85 a 89 años,9835,4628,5207,1995
Oaxaca,90 a 94 años,4457,1928,2529,1995
Oaxaca,95 a 99 años,2299,976,1323,1995
Oaxaca,100 años y más,731,291,440,1995
Oaxaca,No especificado,14723,6561,8162,1995
Puebla,0 a 4 años,574929,290579,284350,1995
Puebla,5 a 9 años,594003,300772,293231,1995
Puebla,10 a 14 años,591644,299025,292619,1995
Puebla,15 a 19 años,526378,259523,266855,1995
Puebla,20 a 24 años,447281,212862,234419,1995
Puebla,25 a 29 años,351785,165411,186374,1995
Puebla,30 a 34 años,299213,140849,158364,1995
Puebla,35 a 39 años,275167,129853,145314,1995
Puebla,40 a 44 años,207950,100039,107911,1995
Puebla,45 a 49 años,175518,83337,92181,1995
Puebla,50 a 54 años,139750,66956,72794,1995
Puebla,55 a 59 años,113605,53333,60272,1995
Puebla,60 a 64 años,100868,47280,53588,1995
Puebla,65 a 69 años,76919,35373,41546,1995
Puebla,70 a 74 años,57670,27227,30443,1995
Puebla,75 a 79 años,38212,18186,20026,1995
Puebla,80 a 84 años,22993,9964,13029,1995
Puebla,85 a 89 años,14447,6285,8162,1995
Puebla,90 a 94 años,6218,2547,3671,1995
Puebla,95 a 99 años,3474,1354,2120,1995
Puebla,100 años y más,1010,311,699,1995
Puebla,No especificado,5331,2410,2921,1995
Querétaro,0 a 4 años,159062,80413,78649,1995
Querétaro,5 a 9 años,159715,80724,78991,1995
Querétaro,10 a 14 años,155971,78843,77128,1995
Querétaro,15 a 19 años,145338,71349,73989,1995
Querétaro,20 a 24 años,130819,62591,68228,1995
Querétaro,25 a 29 años,103287,49042,54245,1995
Querétaro,30 a 34 años,89066,42868,46198,1995
Querétaro,35 a 39 años,77155,37633,39522,1995
Querétaro,40 a 44 años,56445,28124,28321,1995
Querétaro,45 a 49 años,43552,21587,21965,1995
Querétaro,50 a 54 años,33922,16851,17071,1995
Querétaro,55 a 59 años,25227,12280,12947,1995
Querétaro,60 a 64 años,21951,10393,11558,1995
Querétaro,65 a 69 años,15847,7473,8374,1995
Querétaro,70 a 74 años,12377,5987,6390,1995
Querétaro,75 a 79 años,7532,3497,4035,1995
Querétaro,80 a 84 años,5166,2238,2928,1995
Querétaro,85 a 89 años,3162,1399,1763,1995
Querétaro,90 a 94 años,1288,562,726,1995
Querétaro,95 a 99 años,639,255,384,1995
Querétaro,100 años y más,140,46,94,1995
Querétaro,No especificado,2815,1329,1486,1995
Quintana Roo,0 a 4 años,96834,49230,47604,1995
Quintana Roo,5 a 9 años,87369,44445,42924,1995
Quintana Roo,10 a 14 años,77546,39550,37996,1995
Quintana Roo,15 a 19 años,75509,38095,37414,1995
Quintana Roo,20 a 24 años,81267,41218,40049,1995
Quintana Roo,25 a 29 años,72421,37052,35369,1995
Quintana Roo,30 a 34 años,58722,30204,28518,1995
Quintana Roo,35 a 39 años,45621,23653,21968,1995
Quintana Roo,40 a 44 años,31617,16799,14818,1995
Quintana Roo,45 a 49 años,23400,12479,10921,1995
Quintana Roo,50 a 54 años,16174,8719,7455,1995
Quintana Roo,55 a 59 años,11398,6034,5364,1995
Quintana Roo,60 a 64 años,8972,4747,4225,1995
Quintana Roo,65 a 69 años,5655,3053,2602,1995
Quintana Roo,70 a 74 años,4227,2391,1836,1995
Quintana Roo,75 a 79 años,2473,1403,1070,1995
Quintana Roo,80 a 84 años,1392,791,601,1995
Quintana Roo,85 a 89 años,710,408,302,1995
Quintana Roo,90 a 94 años,303,158,145,1995
Quintana Roo,95 a 99 años,142,70,72,1995
Quintana Roo,100 años y más,63,37,26,1995
Quintana Roo,No especificado,1721,923,798,1995
San Luis Potosí,0 a 4 años,279967,141909,138058,1995
San Luis Potosí,5 a 9 años,278902,141801,137101,1995
San Luis Potosí,10 a 14 años,277578,140700,136878,1995
San Luis Potosí,15 a 19 años,246271,122685,123586,1995
San Luis Potosí,20 a 24 años,206873,99110,107763,1995
San Luis Potosí,25 a 29 años,164964,77995,86969,1995
San Luis Potosí,30 a 34 años,143446,68229,75217,1995
San Luis Potosí,35 a 39 años,127109,61324,65785,1995
San Luis Potosí,40 a 44 años,98704,48276,50428,1995
San Luis Potosí,45 a 49 años,83724,41175,42549,1995
San Luis Potosí,50 a 54 años,69022,33914,35108,1995
San Luis Potosí,55 a 59 años,57161,28230,28931,1995
San Luis Potosí,60 a 64 años,51004,25035,25969,1995
San Luis Potosí,65 a 69 años,38714,19067,19647,1995
San Luis Potosí,70 a 74 años,29252,14890,14362,1995
San Luis Potosí,75 a 79 años,16847,8488,8359,1995
San Luis Potosí,80 a 84 años,12110,5735,6375,1995
San Luis Potosí,85 a 89 años,7959,3768,4191,1995
San Luis Potosí,90 a 94 años,3550,1639,1911,1995
San Luis Potosí,95 a 99 años,1557,689,868,1995
San Luis Potosí,100 años y más,403,131,272,1995
San Luis Potosí,No especificado,5646,2710,2936,1995
Sinaloa,0 a 4 años,281823,143911,137912,1995
Sinaloa,5 a 9 años,283285,143939,139346,1995
Sinaloa,10 a 14 años,282968,143623,139345,1995
Sinaloa,15 a 19 años,283114,142881,140233,1995
Sinaloa,20 a 24 años,254765,127511,127254,1995
Sinaloa,25 a 29 años,195551,95466,100085,1995
Sinaloa,30 a 34 años,169208,81771,87437,1995
Sinaloa,35 a 39 años,153271,74295,78976,1995
Sinaloa,40 a 44 años,120409,60004,60405,1995
Sinaloa,45 a 49 años,97272,48985,48287,1995
Sinaloa,50 a 54 años,79839,41054,38785,1995
Sinaloa,55 a 59 años,62917,32389,30528,1995
Sinaloa,60 a 64 años,50727,25879,24848,1995
Sinaloa,65 a 69 años,37861,19148,18713,1995
Sinaloa,70 a 74 años,28195,14339,13856,1995
Sinaloa,75 a 79 años,18345,9100,9245,1995
Sinaloa,80 a 84 años,11668,5445,6223,1995
Sinaloa,85 a 89 años,6781,3057,3724,1995
Sinaloa,90 a 94 años,2358,1037,1321,1995
Sinaloa,95 a 99 años,1151,513,638,1995
Sinaloa,100 años y más,335,137,198,1995
Sinaloa,No especificado,3832,1931,1901,1995
Sonora,0 a 4 años,239515,122220,117295,1995
Sonora,5 a 9 años,233167,118417,114750,1995
Sonora,10 a 14 años,225173,114032,111141,1995
Sonora,15 a 19 años,225130,113890,111240,1995
Sonora,20 a 24 años,219665,110207,109458,1995
Sonora,25 a 29 años,180457,89374,91083,1995
Sonora,30 a 34 años,159506,78380,81126,1995
Sonora,35 a 39 años,143298,70923,72375,1995
Sonora,40 a 44 años,108710,54787,53923,1995
Sonora,45 a 49 años,85758,43323,42435,1995
Sonora,50 a 54 años,69920,35410,34510,1995
Sonora,55 a 59 años,55615,28127,27488,1995
Sonora,60 a 64 años,45734,23133,22601,1995
Sonora,65 a 69 años,34319,17249,17070,1995
Sonora,70 a 74 años,24339,12493,11846,1995
Sonora,75 a 79 años,15612,7755,7857,1995
Sonora,80 a 84 años,8887,3981,4906,1995
Sonora,85 a 89 años,4846,2144,2702,1995
Sonora,90 a 94 años,1536,685,851,1995
Sonora,95 a 99 años,701,305,396,1995
Sonora,100 años y más,183,63,120,1995
Sonora,No especificado,3465,2035,1430,1995
Tabasco,0 a 4 años,216423,109644,106779,1995
Tabasco,5 a 9 años,224135,113280,110855,1995
Tabasco,10 a 14 años,225955,114091,111864,1995
Tabasco,15 a 19 años,207996,102227,105769,1995
Tabasco,20 a 24 años,180648,86928,93720,1995
Tabasco,25 a 29 años,143820,69173,74647,1995
Tabasco,30 a 34 años,123023,60444,62579,1995
Tabasco,35 a 39 años,110421,54958,55463,1995
Tabasco,40 a 44 años,79309,40278,39031,1995
Tabasco,45 a 49 años,61601,31405,30196,1995
Tabasco,50 a 54 años,46169,23567,22602,1995
Tabasco,55 a 59 años,36478,18626,17852,1995
Tabasco,60 a 64 años,30607,15588,15019,1995
Tabasco,65 a 69 años,21043,10624,10419,1995
Tabasco,70 a 74 años,15449,8327,7122,1995
Tabasco,75 a 79 años,9585,4988,4597,1995
Tabasco,80 a 84 años,6064,3121,2943,1995
Tabasco,85 a 89 años,3781,1948,1833,1995
Tabasco,90 a 94 años,1715,870,845,1995
Tabasco,95 a 99 años,982,484,498,1995
Tabasco,100 años y más,523,227,296,1995
Tabasco,No especificado,3042,1445,1597,1995
Tamaulipas,0 a 4 años,282902,144467,138435,1995
Tamaulipas,5 a 9 años,270441,138027,132414,1995
Tamaulipas,10 a 14 años,263237,133432,129805,1995
Tamaulipas,15 a 19 años,275684,137625,138059,1995
Tamaulipas,20 a 24 años,274901,134302,140599,1995
Tamaulipas,25 a 29 años,229796,111930,117866,1995
Tamaulipas,30 a 34 años,195075,95548,99527,1995
Tamaulipas,35 a 39 años,168254,82499,85755,1995
Tamaulipas,40 a 44 años,126389,62336,64053,1995
Tamaulipas,45 a 49 años,103927,50597,53330,1995
Tamaulipas,50 a 54 años,86224,42550,43674,1995
Tamaulipas,55 a 59 años,70066,34462,35604,1995
Tamaulipas,60 a 64 años,59763,29003,30760,1995
Tamaulipas,65 a 69 años,43449,21018,22431,1995
Tamaulipas,70 a 74 años,31519,15467,16052,1995
Tamaulipas,75 a 79 años,17911,8539,9372,1995
Tamaulipas,80 a 84 años,11705,5402,6303,1995
Tamaulipas,85 a 89 años,7576,3517,4059,1995
Tamaulipas,90 a 94 años,2914,1346,1568,1995
Tamaulipas,95 a 99 años,1220,561,659,1995
Tamaulipas,100 años y más,296,116,180,1995
Tamaulipas,No especificado,4079,1956,2123,1995
Tlaxcala,0 a 4 años,106844,54455,52389,1995
Tlaxcala,5 a 9 años,109410,55694,53716,1995
Tlaxcala,10 a 14 años,110597,55744,54853,1995
Tlaxcala,15 a 19 años,103743,51416,52327,1995
Tlaxcala,20 a 24 años,90107,43311,46796,1995
Tlaxcala,25 a 29 años,71169,33868,37301,1995
Tlaxcala,30 a 34 años,61544,29238,32306,1995
Tlaxcala,35 a 39 años,54029,25910,28119,1995
Tlaxcala,40 a 44 años,38503,18878,19625,1995
Tlaxcala,45 a 49 años,31649,15480,16169,1995
Tlaxcala,50 a 54 años,25113,12321,12792,1995
Tlaxcala,55 a 59 años,20211,9745,10466,1995
Tlaxcala,60 a 64 años,18174,8695,9479,1995
Tlaxcala,65 a 69 años,14448,6931,7517,1995
Tlaxcala,70 a 74 años,10838,5324,5514,1995
Tlaxcala,75 a 79 años,7367,3620,3747,1995
Tlaxcala,80 a 84 años,4334,2094,2240,1995
Tlaxcala,85 a 89 años,3127,1477,1650,1995
Tlaxcala,90 a 94 años,1238,557,681,1995
Tlaxcala,95 a 99 años,643,268,375,1995
Tlaxcala,100 años y más,138,43,95,1995
Tlaxcala,No especificado,698,321,377,1995
Veracruz de Ignacio de la Llave,0 a 4 años,776467,395230,381237,1995
Veracruz de Ignacio de la Llave,5 a 9 años,808231,410700,397531,1995
Veracruz de Ignacio de la Llave,10 a 14 años,807421,410912,396509,1995
Veracruz de Ignacio de la Llave,15 a 19 años,735362,366861,368501,1995
Veracruz de Ignacio de la Llave,20 a 24 años,647799,311116,336683,1995
Veracruz de Ignacio de la Llave,25 a 29 años,543854,259835,284019,1995
Veracruz de Ignacio de la Llave,30 a 34 años,474740,228981,245759,1995
Veracruz de Ignacio de la Llave,35 a 39 años,432316,208089,224227,1995
Veracruz de Ignacio de la Llave,40 a 44 años,336144,164379,171765,1995
Veracruz de Ignacio de la Llave,45 a 49 años,284928,139122,145806,1995
Veracruz de Ignacio de la Llave,50 a 54 años,227050,111635,115415,1995
Veracruz de Ignacio de la Llave,55 a 59 años,183424,89307,94117,1995
Veracruz de Ignacio de la Llave,60 a 64 años,154740,74398,80342,1995
Veracruz de Ignacio de la Llave,65 a 69 años,112997,53595,59402,1995
Veracruz de Ignacio de la Llave,70 a 74 años,82096,40157,41939,1995
Veracruz de Ignacio de la Llave,75 a 79 años,51656,24807,26849,1995
Veracruz de Ignacio de la Llave,80 a 84 años,32694,14679,18015,1995
Veracruz de Ignacio de la Llave,85 a 89 años,19582,8781,10801,1995
Veracruz de Ignacio de la Llave,90 a 94 años,8609,3695,4914,1995
Veracruz de Ignacio de la Llave,95 a 99 años,4665,2070,2595,1995
Veracruz de Ignacio de la Llave,100 años y más,1732,645,1087,1995
Veracruz de Ignacio de la Llave,No especificado,10817,4886,5931,1995
Yucatán,0 a 4 años,178063,90324,87739,1995
Yucatán,5 a 9 años,182490,92524,89966,1995
Yucatán,10 a 14 años,180223,91435,88788,1995
Yucatán,15 a 19 años,170674,84925,85749,1995
Yucatán,20 a 24 años,157458,77339,80119,1995
Yucatán,25 a 29 años,120066,58455,61611,1995
Yucatán,30 a 34 años,105949,51436,54513,1995
Yucatán,35 a 39 años,95371,46353,49018,1995
Yucatán,40 a 44 años,79077,38730,40347,1995
Yucatán,45 a 49 años,68487,33760,34727,1995
Yucatán,50 a 54 años,51694,25443,26251,1995
Yucatán,55 a 59 años,41577,20340,21237,1995
Yucatán,60 a 64 años,35797,17516,18281,1995
Yucatán,65 a 69 años,27734,13676,14058,1995
Yucatán,70 a 74 años,23662,12011,11651,1995
Yucatán,75 a 79 años,16966,8731,8235,1995
Yucatán,80 a 84 años,9959,4847,5112,1995
Yucatán,85 a 89 años,5616,2769,2847,1995
Yucatán,90 a 94 años,2127,998,1129,1995
Yucatán,95 a 99 años,794,377,417,1995
Yucatán,100 años y más,147,64,83,1995
Yucatán,No especificado,2691,1382,1309,1995
Zacatecas,0 a 4 años,160610,81928,78682,1995
Zacatecas,5 a 9 años,171797,87400,84397,1995
Zacatecas,10 a 14 años,173536,87970,85566,1995
Zacatecas,15 a 19 años,159590,77607,81983,1995
Zacatecas,20 a 24 años,126861,59278,67583,1995
Zacatecas,25 a 29 años,98409,45720,52689,1995
Zacatecas,30 a 34 años,84527,39772,44755,1995
Zacatecas,35 a 39 años,73092,34745,38347,1995
Zacatecas,40 a 44 años,55923,27009,28914,1995
Zacatecas,45 a 49 años,48555,23360,25195,1995
Zacatecas,50 a 54 años,41667,20389,21278,1995
Zacatecas,55 a 59 años,34251,16837,17414,1995
Zacatecas,60 a 64 años,32177,15849,16328,1995
Zacatecas,65 a 69 años,24586,12218,12368,1995
Zacatecas,70 a 74 años,19451,9945,9506,1995
Zacatecas,75 a 79 años,11604,5840,5764,1995
Zacatecas,80 a 84 años,8671,4219,4452,1995
Zacatecas,85 a 89 años,5504,2775,2729,1995
Zacatecas,90 a 94 años,2355,1165,1190,1995
Zacatecas,95 a 99 años,933,430,503,1995
Zacatecas,100 años y más,192,74,118,1995
Zacatecas,No especificado,2205,1010,1195,1995
Estados Unidos Mexicanos,0 a 4 años,10635157,5401306,5233851,2000
Estados Unidos Mexicanos,5 a 9 años,11215323,5677711,5537612,2000
Estados Unidos Mexicanos,10 a 14 años,10736493,5435737,5300756,2000
Estados Unidos Mexicanos,15 a 19 años,9992135,4909648,5082487,2000
Estados Unidos Mexicanos,20 a 24 años,9071134,4303600,4767534,2000
Estados Unidos Mexicanos,25 a 29 años,8157743,3861482,4296261,2000
Estados Unidos Mexicanos,30 a 34 años,7136523,3383356,3753167,2000
Estados Unidos Mexicanos,35 a 39 años,6352538,3023328,3329210,2000
Estados Unidos Mexicanos,40 a 44 años,5194833,2494771,2700062,2000
Estados Unidos Mexicanos,45 a 49 años,4072091,1957177,2114914,2000
Estados Unidos Mexicanos,50 a 54 años,3357953,1624033,1733920,2000
Estados Unidos Mexicanos,55 a 59 años,2559231,1234072,1325159,2000
Estados Unidos Mexicanos,60 a 64 años,2198146,1045404,1152742,2000
Estados Unidos Mexicanos,65 a 69 años,1660785,779666,881119,2000
Estados Unidos Mexicanos,70 a 74 años,1245674,589106,656568,2000
Estados Unidos Mexicanos,75 a 79 años,865270,411197,454073,2000
Estados Unidos Mexicanos,80 a 84 años,483876,217330,266546,2000
Estados Unidos Mexicanos,85 a 89 años,290051,125041,165010,2000
Estados Unidos Mexicanos,90 a 94 años,122006,50843,71163,2000
Estados Unidos Mexicanos,95 a 99 años,62892,25741,37151,2000
Estados Unidos Mexicanos,100 años y más,19757,8029,11728,2000
Estados Unidos Mexicanos,No especificado,2053801,1033675,1020126,2000
Aguascalientes,0 a 4 años,116137,58831,57306,2000
Aguascalientes,5 a 9 años,117375,59375,58000,2000
Aguascalientes,10 a 14 años,108532,54930,53602,2000
Aguascalientes,15 a 19 años,99577,48733,50844,2000
Aguascalientes,20 a 24 años,87508,40526,46982,2000
Aguascalientes,25 a 29 años,79200,36461,42739,2000
Aguascalientes,30 a 34 años,70317,32438,37879,2000
Aguascalientes,35 a 39 años,60839,28736,32103,2000
Aguascalientes,40 a 44 años,49365,23383,25982,2000
Aguascalientes,45 a 49 años,37541,17855,19686,2000
Aguascalientes,50 a 54 años,30202,14400,15802,2000
Aguascalientes,55 a 59 años,22094,10638,11456,2000
Aguascalientes,60 a 64 años,17759,8129,9630,2000
Aguascalientes,65 a 69 años,13752,6333,7419,2000
Aguascalientes,70 a 74 años,10714,4901,5813,2000
Aguascalientes,75 a 79 años,7754,3648,4106,2000
Aguascalientes,80 a 84 años,4336,1915,2421,2000
Aguascalientes,85 a 89 años,2726,1185,1541,2000
Aguascalientes,90 a 94 años,1169,466,703,2000
Aguascalientes,95 a 99 años,542,241,301,2000
Aguascalientes,100 años y más,102,44,58,2000
Aguascalientes,No especificado,6744,3365,3379,2000
Baja California,0 a 4 años,268682,136979,131703,2000
Baja California,5 a 9 años,260331,132492,127839,2000
Baja California,10 a 14 años,226758,115261,111497,2000
Baja California,15 a 19 años,220707,112046,108661,2000
Baja California,20 a 24 años,231966,115775,116191,2000
Baja California,25 a 29 años,230907,116644,114263,2000
Baja California,30 a 34 años,197807,100728,97079,2000
Baja California,35 a 39 años,165348,83873,81475,2000
Baja California,40 a 44 años,126564,63537,63027,2000
Baja California,45 a 49 años,92839,46040,46799,2000
Baja California,50 a 54 años,73548,36227,37321,2000
Baja California,55 a 59 años,53639,26116,27523,2000
Baja California,60 a 64 años,44174,21414,22760,2000
Baja California,65 a 69 años,32561,15643,16918,2000
Baja California,70 a 74 años,23192,11386,11806,2000
Baja California,75 a 79 años,15403,7530,7873,2000
Baja California,80 a 84 años,8005,3666,4339,2000
Baja California,85 a 89 años,4322,1706,2616,2000
Baja California,90 a 94 años,1675,694,981,2000
Baja California,95 a 99 años,857,340,517,2000
Baja California,100 años y más,266,114,152,2000
Baja California,No especificado,207816,104370,103446,2000
Baja California Sur,0 a 4 años,45613,23303,22310,2000
Baja California Sur,5 a 9 años,45929,23414,22515,2000
Baja California Sur,10 a 14 años,43302,22058,21244,2000
Baja California Sur,15 a 19 años,42376,21922,20454,2000
Baja California Sur,20 a 24 años,42278,21345,20933,2000
Baja California Sur,25 a 29 años,40264,20373,19891,2000
Baja California Sur,30 a 34 años,35609,18036,17573,2000
Baja California Sur,35 a 39 años,31282,15778,15504,2000
Baja California Sur,40 a 44 años,25053,12759,12294,2000
Baja California Sur,45 a 49 años,18593,9702,8891,2000
Baja California Sur,50 a 54 años,14109,7329,6780,2000
Baja California Sur,55 a 59 años,10631,5492,5139,2000
Baja California Sur,60 a 64 años,8248,4294,3954,2000
Baja California Sur,65 a 69 años,6145,3169,2976,2000
Baja California Sur,70 a 74 años,4176,2107,2069,2000
Baja California Sur,75 a 79 años,2894,1437,1457,2000
Baja California Sur,80 a 84 años,1725,790,935,2000
Baja California Sur,85 a 89 años,966,408,558,2000
Baja California Sur,90 a 94 años,361,161,200,2000
Baja California Sur,95 a 99 años,221,80,141,2000
Baja California Sur,100 años y más,53,23,30,2000
Baja California Sur,No especificado,4213,2270,1943,2000
Campeche,0 a 4 años,78424,39670,38754,2000
Campeche,5 a 9 años,83090,41982,41108,2000
Campeche,10 a 14 años,80246,40529,39717,2000
Campeche,15 a 19 años,73769,36751,37018,2000
Campeche,20 a 24 años,66395,31911,34484,2000
Campeche,25 a 29 años,57599,27661,29938,2000
Campeche,30 a 34 años,50021,24435,25586,2000
Campeche,35 a 39 años,45603,22444,23159,2000
Campeche,40 a 44 años,36088,18061,18027,2000
Campeche,45 a 49 años,28962,14474,14488,2000
Campeche,50 a 54 años,22362,11346,11016,2000
Campeche,55 a 59 años,16699,8540,8159,2000
Campeche,60 a 64 años,14546,7371,7175,2000
Campeche,65 a 69 años,10683,5389,5294,2000
Campeche,70 a 74 años,8374,4412,3962,2000
Campeche,75 a 79 años,5787,3093,2694,2000
Campeche,80 a 84 años,3421,1789,1632,2000
Campeche,85 a 89 años,1777,912,865,2000
Campeche,90 a 94 años,714,370,344,2000
Campeche,95 a 99 años,414,205,209,2000
Campeche,100 años y más,149,79,70,2000
Campeche,No especificado,5566,2910,2656,2000
Coahuila de Zaragoza,0 a 4 años,253171,129130,124041,2000
Coahuila de Zaragoza,5 a 9 años,257228,130718,126510,2000
Coahuila de Zaragoza,10 a 14 años,234659,119135,115524,2000
Coahuila de Zaragoza,15 a 19 años,225416,113776,111640,2000
Coahuila de Zaragoza,20 a 24 años,223857,110790,113067,2000
Coahuila de Zaragoza,25 a 29 años,204662,99588,105074,2000
Coahuila de Zaragoza,30 a 34 años,179690,86903,92787,2000
Coahuila de Zaragoza,35 a 39 años,157386,76375,81011,2000
Coahuila de Zaragoza,40 a 44 años,128951,63095,65856,2000
Coahuila de Zaragoza,45 a 49 años,98997,48525,50472,2000
Coahuila de Zaragoza,50 a 54 años,82932,40702,42230,2000
Coahuila de Zaragoza,55 a 59 años,63057,30959,32098,2000
Coahuila de Zaragoza,60 a 64 años,53853,26017,27836,2000
Coahuila de Zaragoza,65 a 69 años,39173,18870,20303,2000
Coahuila de Zaragoza,70 a 74 años,28943,13890,15053,2000
Coahuila de Zaragoza,75 a 79 años,19396,9322,10074,2000
Coahuila de Zaragoza,80 a 84 años,10102,4679,5423,2000
Coahuila de Zaragoza,85 a 89 años,6051,2555,3496,2000
Coahuila de Zaragoza,90 a 94 años,2420,991,1429,2000
Coahuila de Zaragoza,95 a 99 años,1027,428,599,2000
Coahuila de Zaragoza,100 años y más,253,87,166,2000
Coahuila de Zaragoza,No especificado,26846,13660,13186,2000
Colima,0 a 4 años,53295,27427,25868,2000
Colima,5 a 9 años,57165,29298,27867,2000
Colima,10 a 14 años,57422,29057,28365,2000
Colima,15 a 19 años,54826,27289,27537,2000
Colima,20 a 24 años,48878,23281,25597,2000
Colima,25 a 29 años,43310,20598,22712,2000
Colima,30 a 34 años,38024,17968,20056,2000
Colima,35 a 39 años,35524,17173,18351,2000
Colima,40 a 44 años,29529,14500,15029,2000
Colima,45 a 49 años,22683,11218,11465,2000
Colima,50 a 54 años,18269,9096,9173,2000
Colima,55 a 59 años,14053,7006,7047,2000
Colima,60 a 64 años,11339,5529,5810,2000
Colima,65 a 69 años,8777,4211,4566,2000
Colima,70 a 74 años,6599,3297,3302,2000
Colima,75 a 79 años,5086,2532,2554,2000
Colima,80 a 84 años,3129,1474,1655,2000
Colima,85 a 89 años,1879,849,1030,2000
Colima,90 a 94 años,760,332,428,2000
Colima,95 a 99 años,397,180,217,2000
Colima,100 años y más,128,59,69,2000
Colima,No especificado,31555,15818,15737,2000
Chiapas,0 a 4 años,483372,245014,238358,2000
Chiapas,5 a 9 años,518550,261521,257029,2000
Chiapas,10 a 14 años,488791,247331,241460,2000
Chiapas,15 a 19 años,433517,212353,221164,2000
Chiapas,20 a 24 años,361994,172044,189950,2000
Chiapas,25 a 29 años,292960,138292,154668,2000
Chiapas,30 a 34 años,242588,116714,125874,2000
Chiapas,35 a 39 años,226620,109185,117435,2000
Chiapas,40 a 44 años,174699,87135,87564,2000
Chiapas,45 a 49 años,141959,70479,71480,2000
Chiapas,50 a 54 años,110635,56191,54444,2000
Chiapas,55 a 59 años,83843,42296,41547,2000
Chiapas,60 a 64 años,72099,36805,35294,2000
Chiapas,65 a 69 años,49327,24592,24735,2000
Chiapas,70 a 74 años,37597,19429,18168,2000
Chiapas,75 a 79 años,23858,12422,11436,2000
Chiapas,80 a 84 años,14768,7451,7317,2000
Chiapas,85 a 89 años,7712,3817,3895,2000
Chiapas,90 a 94 años,3896,1892,2004,2000
Chiapas,95 a 99 años,2309,1126,1183,2000
Chiapas,100 años y más,1241,611,630,2000
Chiapas,No especificado,148557,75180,73377,2000
Chihuahua,0 a 4 años,334521,169900,164621,2000
Chihuahua,5 a 9 años,341921,173436,168485,2000
Chihuahua,10 a 14 años,306679,155835,150844,2000
Chihuahua,15 a 19 años,290939,147754,143185,2000
Chihuahua,20 a 24 años,280013,139615,140398,2000
Chihuahua,25 a 29 años,272404,134363,138041,2000
Chihuahua,30 a 34 años,242428,119203,123225,2000
Chihuahua,35 a 39 años,207365,101506,105859,2000
Chihuahua,40 a 44 años,162697,79276,83421,2000
Chihuahua,45 a 49 años,121932,58943,62989,2000
Chihuahua,50 a 54 años,103012,50052,52960,2000
Chihuahua,55 a 59 años,81615,39566,42049,2000
Chihuahua,60 a 64 años,71437,34821,36616,2000
Chihuahua,65 a 69 años,51719,25177,26542,2000
Chihuahua,70 a 74 años,37728,18255,19473,2000
Chihuahua,75 a 79 años,24488,11965,12523,2000
Chihuahua,80 a 84 años,12813,5889,6924,2000
Chihuahua,85 a 89 años,7526,3344,4182,2000
Chihuahua,90 a 94 años,2770,1166,1604,2000
Chihuahua,95 a 99 años,1242,531,711,2000
Chihuahua,100 años y más,329,148,181,2000
Chihuahua,No especificado,97329,49227,48102,2000
Ciudad de México,0 a 4 años,737934,375222,362712,2000
Ciudad de México,5 a 9 años,764094,387936,376158,2000
Ciudad de México,10 a 14 años,742986,375369,367617,2000
Ciudad de México,15 a 19 años,798349,390049,408300,2000
Ciudad de México,20 a 24 años,832517,400924,431593,2000
Ciudad de México,25 a 29 años,840487,403311,437176,2000
Ciudad de México,30 a 34 años,731452,346860,384592,2000
Ciudad de México,35 a 39 años,655973,307235,348738,2000
Ciudad de México,40 a 44 años,556565,258920,297645,2000
Ciudad de México,45 a 49 años,441804,203214,238590,2000
Ciudad de México,50 a 54 años,373595,171939,201656,2000
Ciudad de México,55 a 59 años,269845,122660,147185,2000
Ciudad de México,60 a 64 años,227283,99194,128089,2000
Ciudad de México,65 a 69 años,175174,73983,101191,2000
Ciudad de México,70 a 74 años,134345,55057,79288,2000
Ciudad de México,75 a 79 años,92943,38025,54918,2000
Ciudad de México,80 a 84 años,51638,19383,32255,2000
Ciudad de México,85 a 89 años,30845,10712,20133,2000
Ciudad de México,90 a 94 años,12237,3971,8266,2000
Ciudad de México,95 a 99 años,5012,1565,3447,2000
Ciudad de México,100 años y más,1163,413,750,2000
Ciudad de México,No especificado,128998,64543,64455,2000
Durango,0 a 4 años,168897,85927,82970,2000
Durango,5 a 9 años,177062,89736,87326,2000
Durango,10 a 14 años,172365,87255,85110,2000
Durango,15 a 19 años,150569,74630,75939,2000
Durango,20 a 24 años,129322,61380,67942,2000
Durango,25 a 29 años,113003,53011,59992,2000
Durango,30 a 34 años,100022,46641,53381,2000
Durango,35 a 39 años,90218,42492,47726,2000
Durango,40 a 44 años,73203,34716,38487,2000
Durango,45 a 49 años,57469,27538,29931,2000
Durango,50 a 54 años,48972,23698,25274,2000
Durango,55 a 59 años,39206,19190,20016,2000
Durango,60 a 64 años,36689,17978,18711,2000
Durango,65 a 69 años,27761,13685,14076,2000
Durango,70 a 74 años,20362,10158,10204,2000
Durango,75 a 79 años,13433,6802,6631,2000
Durango,80 a 84 años,6877,3247,3630,2000
Durango,85 a 89 años,4431,2068,2363,2000
Durango,90 a 94 años,1906,856,1050,2000
Durango,95 a 99 años,886,383,503,2000
Durango,100 años y más,255,104,151,2000
Durango,No especificado,15753,8026,7727,2000
Guanajuato,0 a 4 años,564593,286535,278058,2000
Guanajuato,5 a 9 años,582207,293238,288969,2000
Guanajuato,10 a 14 años,560147,282245,277902,2000
Guanajuato,15 a 19 años,501053,238000,263053,2000
Guanajuato,20 a 24 años,435713,195148,240565,2000
Guanajuato,25 a 29 años,371568,167169,204399,2000
Guanajuato,30 a 34 años,322249,147304,174945,2000
Guanajuato,35 a 39 años,280637,129610,151027,2000
Guanajuato,40 a 44 años,229441,107801,121640,2000
Guanajuato,45 a 49 años,177786,84189,93597,2000
Guanajuato,50 a 54 años,146282,69721,76561,2000
Guanajuato,55 a 59 años,111802,53119,58683,2000
Guanajuato,60 a 64 años,98676,46357,52319,2000
Guanajuato,65 a 69 años,76586,36029,40557,2000
Guanajuato,70 a 74 años,62089,29690,32399,2000
Guanajuato,75 a 79 años,42290,20215,22075,2000
Guanajuato,80 a 84 años,23925,10852,13073,2000
Guanajuato,85 a 89 años,15706,7049,8657,2000
Guanajuato,90 a 94 años,7235,3143,4092,2000
Guanajuato,95 a 99 años,3680,1528,2152,2000
Guanajuato,100 años y más,878,341,537,2000
Guanajuato,No especificado,48489,24032,24457,2000
Guerrero,0 a 4 años,391873,198055,193818,2000
Guerrero,5 a 9 años,411408,208037,203371,2000
Guerrero,10 a 14 años,394613,199865,194748,2000
Guerrero,15 a 19 años,333331,161191,172140,2000
Guerrero,20 a 24 años,265129,122169,142960,2000
Guerrero,25 a 29 años,215653,99525,116128,2000
Guerrero,30 a 34 años,186082,85746,100336,2000
Guerrero,35 a 39 años,176165,81594,94571,2000
Guerrero,40 a 44 años,142041,67300,74741,2000
Guerrero,45 a 49 años,117329,55640,61689,2000
Guerrero,50 a 54 años,96611,46272,50339,2000
Guerrero,55 a 59 años,76908,36481,40427,2000
Guerrero,60 a 64 años,72841,34344,38497,2000
Guerrero,65 a 69 años,54139,25200,28939,2000
Guerrero,70 a 74 años,42207,20193,22014,2000
Guerrero,75 a 79 años,26950,13153,13797,2000
Guerrero,80 a 84 años,17112,7872,9240,2000
Guerrero,85 a 89 años,9120,4185,4935,2000
Guerrero,90 a 94 años,4558,2034,2524,2000
Guerrero,95 a 99 años,2711,1219,1492,2000
Guerrero,100 años y más,1224,538,686,2000
Guerrero,No especificado,41644,20674,20970,2000
Hidalgo,0 a 4 años,243558,123609,119949,2000
Hidalgo,5 a 9 años,277830,140645,137185,2000
Hidalgo,10 a 14 años,271378,137272,134106,2000
Hidalgo,15 a 19 años,235368,114428,120940,2000
Hidalgo,20 a 24 años,195771,88949,106822,2000
Hidalgo,25 a 29 años,172960,78718,94242,2000
Hidalgo,30 a 34 años,155351,71301,84050,2000
Hidalgo,35 a 39 años,143447,66909,76538,2000
Hidalgo,40 a 44 años,117852,56602,61250,2000
Hidalgo,45 a 49 años,95309,46488,48821,2000
Hidalgo,50 a 54 años,77766,38145,39621,2000
Hidalgo,55 a 59 años,60808,29879,30929,2000
Hidalgo,60 a 64 años,51719,24910,26809,2000
Hidalgo,65 a 69 años,40119,19103,21016,2000
Hidalgo,70 a 74 años,30440,14494,15946,2000
Hidalgo,75 a 79 años,21911,10518,11393,2000
Hidalgo,80 a 84 años,12770,5727,7043,2000
Hidalgo,85 a 89 años,7406,3139,4267,2000
Hidalgo,90 a 94 años,3268,1274,1994,2000
Hidalgo,95 a 99 años,1835,686,1149,2000
Hidalgo,100 años y más,660,227,433,2000
Hidalgo,No especificado,18065,8970,9095,2000
Jalisco,0 a 4 años,703272,357599,345673,2000
Jalisco,5 a 9 años,720270,365438,354832,2000
Jalisco,10 a 14 años,708813,358780,350033,2000
Jalisco,15 a 19 años,673570,331655,341915,2000
Jalisco,20 a 24 años,589706,276164,313542,2000
Jalisco,25 a 29 años,529194,248483,280711,2000
Jalisco,30 a 34 años,453186,211880,241306,2000
Jalisco,35 a 39 años,397738,186637,211101,2000
Jalisco,40 a 44 años,334653,158651,176002,2000
Jalisco,45 a 49 años,264177,125130,139047,2000
Jalisco,50 a 54 años,224975,107972,117003,2000
Jalisco,55 a 59 años,169779,81869,87910,2000
Jalisco,60 a 64 años,140629,66144,74485,2000
Jalisco,65 a 69 años,108075,50693,57382,2000
Jalisco,70 a 74 años,84182,39184,44998,2000
Jalisco,75 a 79 años,63716,30017,33699,2000
Jalisco,80 a 84 años,39463,17838,21625,2000
Jalisco,85 a 89 años,24151,10772,13379,2000
Jalisco,90 a 94 años,9701,4103,5598,2000
Jalisco,95 a 99 años,4405,1819,2586,2000
Jalisco,100 años y más,1097,427,670,2000
Jalisco,No especificado,77250,38986,38264,2000
México,0 a 4 años,1366320,693821,672499,2000
México,5 a 9 años,1447047,731860,715187,2000
México,10 a 14 años,1363554,689319,674235,2000
México,15 a 19 años,1307977,645046,662931,2000
México,20 a 24 años,1250900,600382,650518,2000
México,25 a 29 años,1154041,548872,605169,2000
México,30 a 34 años,1008308,480221,528087,2000
México,35 a 39 años,883172,420989,462183,2000
México,40 a 44 años,706988,341811,365177,2000
México,45 a 49 años,535083,259150,275933,2000
México,50 a 54 años,422987,206575,216412,2000
México,55 a 59 años,303755,147106,156649,2000
México,60 a 64 años,242540,114932,127608,2000
México,65 a 69 años,178159,82133,96026,2000
México,70 a 74 años,123108,56031,67077,2000
México,75 a 79 años,84377,38231,46146,2000
México,80 a 84 años,41618,17412,24206,2000
México,85 a 89 años,25874,10056,15818,2000
México,90 a 94 años,10206,3640,6566,2000
México,95 a 99 años,6030,2107,3923,2000
México,100 años y más,1792,656,1136,2000
México,No especificado,632850,316863,315987,2000
Michoacán de Ocampo,0 a 4 años,453339,229097,224242,2000
Michoacán de Ocampo,5 a 9 años,492453,248571,243882,2000
Michoacán de Ocampo,10 a 14 años,498316,251262,247054,2000
Michoacán de Ocampo,15 a 19 años,436043,207543,228500,2000
Michoacán de Ocampo,20 a 24 años,357857,159888,197969,2000
Michoacán de Ocampo,25 a 29 años,294099,132374,161725,2000
Michoacán de Ocampo,30 a 34 años,255792,115836,139956,2000
Michoacán de Ocampo,35 a 39 años,233456,107652,125804,2000
Michoacán de Ocampo,40 a 44 años,196428,92879,103549,2000
Michoacán de Ocampo,45 a 49 años,154267,73326,80941,2000
Michoacán de Ocampo,50 a 54 años,132493,63146,69347,2000
Michoacán de Ocampo,55 a 59 años,102326,48464,53862,2000
Michoacán de Ocampo,60 a 64 años,94498,44526,49972,2000
Michoacán de Ocampo,65 a 69 años,75177,35293,39884,2000
Michoacán de Ocampo,70 a 74 años,61639,29772,31867,2000
Michoacán de Ocampo,75 a 79 años,42177,20718,21459,2000
Michoacán de Ocampo,80 a 84 años,25242,11868,13374,2000
Michoacán de Ocampo,85 a 89 años,15131,7120,8011,2000
Michoacán de Ocampo,90 a 94 años,6983,3189,3794,2000
Michoacán de Ocampo,95 a 99 años,3764,1592,2172,2000
Michoacán de Ocampo,100 años y más,1216,537,679,2000
Michoacán de Ocampo,No especificado,52971,26425,26546,2000
Morelos,0 a 4 años,160901,81500,79401,2000
Morelos,5 a 9 años,173589,87866,85723,2000
Morelos,10 a 14 años,166002,84615,81387,2000
Morelos,15 a 19 años,156544,76095,80449,2000
Morelos,20 a 24 años,137988,63439,74549,2000
Morelos,25 a 29 años,123189,56284,66905,2000
Morelos,30 a 34 años,109174,50137,59037,2000
Morelos,35 a 39 años,100957,46951,54006,2000
Morelos,40 a 44 años,84779,40113,44666,2000
Morelos,45 a 49 años,66776,32002,34774,2000
Morelos,50 a 54 años,53966,26075,27891,2000
Morelos,55 a 59 años,41813,19884,21929,2000
Morelos,60 a 64 años,36295,16989,19306,2000
Morelos,65 a 69 años,30268,14059,16209,2000
Morelos,70 a 74 años,22033,10422,11611,2000
Morelos,75 a 79 años,15196,7330,7866,2000
Morelos,80 a 84 años,7620,3490,4130,2000
Morelos,85 a 89 años,4953,2138,2815,2000
Morelos,90 a 94 años,2081,912,1169,2000
Morelos,95 a 99 años,1260,541,719,2000
Morelos,100 años y más,409,154,255,2000
Morelos,No especificado,59503,29803,29700,2000
Nayarit,0 a 4 años,100288,51107,49181,2000
Nayarit,5 a 9 años,107577,54727,52850,2000
Nayarit,10 a 14 años,107654,54737,52917,2000
Nayarit,15 a 19 años,97866,49021,48845,2000
Nayarit,20 a 24 años,81566,38786,42780,2000
Nayarit,25 a 29 años,72014,34447,37567,2000
Nayarit,30 a 34 años,62272,29734,32538,2000
Nayarit,35 a 39 años,57414,27608,29806,2000
Nayarit,40 a 44 años,49594,24008,25586,2000
Nayarit,45 a 49 años,40204,19711,20493,2000
Nayarit,50 a 54 años,33520,16820,16700,2000
Nayarit,55 a 59 años,27584,13924,13660,2000
Nayarit,60 a 64 años,23746,11964,11782,2000
Nayarit,65 a 69 años,18487,9317,9170,2000
Nayarit,70 a 74 años,13556,6913,6643,2000
Nayarit,75 a 79 años,9933,4981,4952,2000
Nayarit,80 a 84 años,6070,2902,3168,2000
Nayarit,85 a 89 años,3838,1826,2012,2000
Nayarit,90 a 94 años,1450,682,768,2000
Nayarit,95 a 99 años,680,316,364,2000
Nayarit,100 años y más,238,110,128,2000
Nayarit,No especificado,4634,2464,2170,2000
Nuevo León,0 a 4 años,396563,201948,194615,2000
Nuevo León,5 a 9 años,385771,196456,189315,2000
Nuevo León,10 a 14 años,355194,180250,174944,2000
Nuevo León,15 a 19 años,373807,187079,186728,2000
Nuevo León,20 a 24 años,391235,195585,195650,2000
Nuevo León,25 a 29 años,369135,183270,185865,2000
Nuevo León,30 a 34 años,322572,158942,163630,2000
Nuevo León,35 a 39 años,272200,134659,137541,2000
Nuevo León,40 a 44 años,224330,110097,114233,2000
Nuevo León,45 a 49 años,168680,82616,86064,2000
Nuevo León,50 a 54 años,144499,70886,73613,2000
Nuevo León,55 a 59 años,109729,53878,55851,2000
Nuevo León,60 a 64 años,92626,44938,47688,2000
Nuevo León,65 a 69 años,65875,31411,34464,2000
Nuevo León,70 a 74 años,48611,22607,26004,2000
Nuevo León,75 a 79 años,33324,15550,17774,2000
Nuevo León,80 a 84 años,17528,7667,9861,2000
Nuevo León,85 a 89 años,10634,4424,6210,2000
Nuevo León,90 a 94 años,4154,1677,2477,2000
Nuevo León,95 a 99 años,1741,664,1077,2000
Nuevo León,100 años y más,380,164,216,2000
Nuevo León,No especificado,45553,23171,22382,2000
Oaxaca,0 a 4 años,395993,200413,195580,2000
Oaxaca,5 a 9 años,458507,230819,227688,2000
Oaxaca,10 a 14 años,443874,224737,219137,2000
Oaxaca,15 a 19 años,364876,177322,187554,2000
Oaxaca,20 a 24 años,288035,130967,157068,2000
Oaxaca,25 a 29 años,239657,109330,130327,2000
Oaxaca,30 a 34 años,213839,98179,115660,2000
Oaxaca,35 a 39 años,199131,92160,106971,2000
Oaxaca,40 a 44 años,167187,78342,88845,2000
Oaxaca,45 a 49 años,139877,65800,74077,2000
Oaxaca,50 a 54 años,116999,55337,61662,2000
Oaxaca,55 a 59 años,96806,45487,51319,2000
Oaxaca,60 a 64 años,89096,42185,46911,2000
Oaxaca,65 a 69 años,68801,32165,36636,2000
Oaxaca,70 a 74 años,52015,25100,26915,2000
Oaxaca,75 a 79 años,36889,17946,18943,2000
Oaxaca,80 a 84 años,22243,10161,12082,2000
Oaxaca,85 a 89 años,12144,5476,6668,2000
Oaxaca,90 a 94 años,5243,2301,2942,2000
Oaxaca,95 a 99 años,2871,1176,1695,2000
Oaxaca,100 años y más,1013,421,592,2000
Oaxaca,No especificado,23669,11582,12087,2000
Puebla,0 a 4 años,578641,293332,285309,2000
Puebla,5 a 9 años,623917,314710,309207,2000
Puebla,10 a 14 años,600452,303571,296881,2000
Puebla,15 a 19 años,532196,258724,273472,2000
Puebla,20 a 24 años,460965,214250,246715,2000
Puebla,25 a 29 años,384326,178237,206089,2000
Puebla,30 a 34 años,332646,153434,179212,2000
Puebla,35 a 39 años,297693,138467,159226,2000
Puebla,40 a 44 años,243578,114420,129158,2000
Puebla,45 a 49 años,197500,92631,104869,2000
Puebla,50 a 54 años,162662,76667,85995,2000
Puebla,55 a 59 años,127639,59810,67829,2000
Puebla,60 a 64 años,111996,51913,60083,2000
Puebla,65 a 69 años,89492,40477,49015,2000
Puebla,70 a 74 años,67351,31233,36118,2000
Puebla,75 a 79 años,48685,22735,25950,2000
Puebla,80 a 84 años,27369,12137,15232,2000
Puebla,85 a 89 años,16421,6957,9464,2000
Puebla,90 a 94 años,7044,2835,4209,2000
Puebla,95 a 99 años,4142,1559,2583,2000
Puebla,100 años y más,1288,421,867,2000
Puebla,No especificado,160683,80281,80402,2000
Querétaro,0 a 4 años,163581,83110,80471,2000
Querétaro,5 a 9 años,174551,87912,86639,2000
Querétaro,10 a 14 años,164074,82482,81592,2000
Querétaro,15 a 19 años,152906,73825,79081,2000
Querétaro,20 a 24 años,136899,63403,73496,2000
Querétaro,25 a 29 años,119099,55547,63552,2000
Querétaro,30 a 34 años,103722,48193,55529,2000
Querétaro,35 a 39 años,90271,43023,47248,2000
Querétaro,40 a 44 años,72087,34784,37303,2000
Querétaro,45 a 49 años,53778,26143,27635,2000
Querétaro,50 a 54 años,41725,20337,21388,2000
Querétaro,55 a 59 años,31402,15160,16242,2000
Querétaro,60 a 64 años,25807,12175,13632,2000
Querétaro,65 a 69 años,19724,9247,10477,2000
Querétaro,70 a 74 años,15069,7071,7998,2000
Querétaro,75 a 79 años,10678,5062,5616,2000
Querétaro,80 a 84 años,5795,2522,3273,2000
Querétaro,85 a 89 años,3719,1523,2196,2000
Querétaro,90 a 94 años,1683,660,1023,2000
Querétaro,95 a 99 años,868,351,517,2000
Querétaro,100 años y más,231,93,138,2000
Querétaro,No especificado,16637,8343,8294,2000
Quintana Roo,0 a 4 años,105575,54075,51500,2000
Quintana Roo,5 a 9 años,105081,53180,51901,2000
Quintana Roo,10 a 14 años,90648,46119,44529,2000
Quintana Roo,15 a 19 años,88870,45249,43621,2000
Quintana Roo,20 a 24 años,94752,47989,46763,2000
Quintana Roo,25 a 29 años,90750,45804,44946,2000
Quintana Roo,30 a 34 años,77734,39932,37802,2000
Quintana Roo,35 a 39 años,61416,31674,29742,2000
Quintana Roo,40 a 44 años,43641,22769,20872,2000
Quintana Roo,45 a 49 años,31473,16553,14920,2000
Quintana Roo,50 a 54 años,23169,12359,10810,2000
Quintana Roo,55 a 59 años,15498,8164,7334,2000
Quintana Roo,60 a 64 años,11995,6274,5721,2000
Quintana Roo,65 a 69 años,7861,4015,3846,2000
Quintana Roo,70 a 74 años,5226,2819,2407,2000
Quintana Roo,75 a 79 años,3641,2027,1614,2000
Quintana Roo,80 a 84 años,1984,1076,908,2000
Quintana Roo,85 a 89 años,1006,537,469,2000
Quintana Roo,90 a 94 años,361,188,173,2000
Quintana Roo,95 a 99 años,227,136,91,2000
Quintana Roo,100 años y más,109,63,46,2000
Quintana Roo,No especificado,13946,7306,6640,2000
San Luis Potosí,0 a 4 años,268764,135872,132892,2000
San Luis Potosí,5 a 9 años,290504,147015,143489,2000
San Luis Potosí,10 a 14 años,277667,140526,137141,2000
San Luis Potosí,15 a 19 años,241303,117718,123585,2000
San Luis Potosí,20 a 24 años,198991,92557,106434,2000
San Luis Potosí,25 a 29 años,173542,80316,93226,2000
San Luis Potosí,30 a 34 años,155396,72232,83164,2000
San Luis Potosí,35 a 39 años,139428,65768,73660,2000
San Luis Potosí,40 a 44 años,115022,55132,59890,2000
San Luis Potosí,45 a 49 años,91334,44117,47217,2000
San Luis Potosí,50 a 54 años,78078,37879,40199,2000
San Luis Potosí,55 a 59 años,62406,30541,31865,2000
San Luis Potosí,60 a 64 años,57657,27835,29822,2000
San Luis Potosí,65 a 69 años,44101,21643,22458,2000
San Luis Potosí,70 a 74 años,34381,17027,17354,2000
San Luis Potosí,75 a 79 años,24001,12027,11974,2000
San Luis Potosí,80 a 84 años,12141,5860,6281,2000
San Luis Potosí,85 a 89 años,8117,3726,4391,2000
San Luis Potosí,90 a 94 años,3908,1718,2190,2000
San Luis Potosí,95 a 99 años,1982,855,1127,2000
San Luis Potosí,100 años y más,580,227,353,2000
San Luis Potosí,No especificado,20057,10246,9811,2000
Sinaloa,0 a 4 años,280226,142796,137430,2000
Sinaloa,5 a 9 años,293365,148806,144559,2000
Sinaloa,10 a 14 años,282780,144221,138559,2000
Sinaloa,15 a 19 años,267418,134696,132722,2000
Sinaloa,20 a 24 años,240944,118951,121993,2000
Sinaloa,25 a 29 años,211879,102847,109032,2000
Sinaloa,30 a 34 años,182741,88252,94489,2000
Sinaloa,35 a 39 años,165228,79430,85798,2000
Sinaloa,40 a 44 años,140257,68165,72092,2000
Sinaloa,45 a 49 años,108884,53727,55157,2000
Sinaloa,50 a 54 años,91022,45766,45256,2000
Sinaloa,55 a 59 años,72198,36751,35447,2000
Sinaloa,60 a 64 años,60539,30717,29822,2000
Sinaloa,65 a 69 años,43760,21897,21863,2000
Sinaloa,70 a 74 años,32080,16165,15915,2000
Sinaloa,75 a 79 años,22153,10939,11214,2000
Sinaloa,80 a 84 años,13422,6292,7130,2000
Sinaloa,85 a 89 años,7860,3526,4334,2000
Sinaloa,90 a 94 años,2930,1261,1669,2000
Sinaloa,95 a 99 años,1379,609,770,2000
Sinaloa,100 años y más,459,190,269,2000
Sinaloa,No especificado,15320,8139,7181,2000
Sonora,0 a 4 años,244619,124895,119724,2000
Sonora,5 a 9 años,246494,125302,121192,2000
Sonora,10 a 14 años,228055,115733,112322,2000
Sonora,15 a 19 años,218530,110432,108098,2000
Sonora,20 a 24 años,210638,104754,105884,2000
Sonora,25 a 29 años,195388,96583,98805,2000
Sonora,30 a 34 años,172782,84967,87815,2000
Sonora,35 a 39 años,154516,76116,78400,2000
Sonora,40 a 44 años,131251,65236,66015,2000
Sonora,45 a 49 años,99234,49469,49765,2000
Sonora,50 a 54 años,80037,40221,39816,2000
Sonora,55 a 59 años,61747,30932,30815,2000
Sonora,60 a 64 años,52615,26211,26404,2000
Sonora,65 a 69 años,38990,19465,19525,2000
Sonora,70 a 74 años,28081,13992,14089,2000
Sonora,75 a 79 años,19133,9546,9587,2000
Sonora,80 a 84 años,10430,4768,5662,2000
Sonora,85 a 89 años,5569,2411,3158,2000
Sonora,90 a 94 años,1964,809,1155,2000
Sonora,95 a 99 años,872,377,495,2000
Sonora,100 años y más,291,128,163,2000
Sonora,No especificado,15733,8243,7490,2000
Tabasco,0 a 4 años,213787,108402,105385,2000
Tabasco,5 a 9 años,228831,115198,113633,2000
Tabasco,10 a 14 años,228638,115487,113151,2000
Tabasco,15 a 19 años,212731,103712,109019,2000
Tabasco,20 a 24 años,187604,88414,99190,2000
Tabasco,25 a 29 años,159811,75114,84697,2000
Tabasco,30 a 34 años,137071,66120,70951,2000
Tabasco,35 a 39 años,127391,62556,64835,2000
Tabasco,40 a 44 años,97004,48328,48676,2000
Tabasco,45 a 49 años,76068,38312,37756,2000
Tabasco,50 a 54 años,56490,28725,27765,2000
Tabasco,55 a 59 años,42339,21172,21167,2000
Tabasco,60 a 64 años,36344,18246,18098,2000
Tabasco,65 a 69 años,26854,13283,13571,2000
Tabasco,70 a 74 años,18952,9894,9058,2000
Tabasco,75 a 79 años,12879,6724,6155,2000
Tabasco,80 a 84 años,7156,3607,3549,2000
Tabasco,85 a 89 años,4324,2114,2210,2000
Tabasco,90 a 94 años,2081,1015,1066,2000
Tabasco,95 a 99 años,1225,624,601,2000
Tabasco,100 años y más,573,273,300,2000
Tabasco,No especificado,13676,7195,6481,2000
Tamaulipas,0 a 4 años,296314,151229,145085,2000
Tamaulipas,5 a 9 años,294747,149746,145001,2000
Tamaulipas,10 a 14 años,270114,137462,132652,2000
Tamaulipas,15 a 19 años,271411,134951,136460,2000
Tamaulipas,20 a 24 años,272292,132737,139555,2000
Tamaulipas,25 a 29 años,252514,122317,130197,2000
Tamaulipas,30 a 34 años,222680,108057,114623,2000
Tamaulipas,35 a 39 años,190906,93099,97807,2000
Tamaulipas,40 a 44 años,154690,75506,79184,2000
Tamaulipas,45 a 49 años,116567,56909,59658,2000
Tamaulipas,50 a 54 años,98820,47668,51152,2000
Tamaulipas,55 a 59 años,76894,37471,39423,2000
Tamaulipas,60 a 64 años,67945,32371,35574,2000
Tamaulipas,65 a 69 años,50474,24123,26351,2000
Tamaulipas,70 a 74 años,36696,17593,19103,2000
Tamaulipas,75 a 79 años,24953,12103,12850,2000
Tamaulipas,80 a 84 años,12307,5559,6748,2000
Tamaulipas,85 a 89 años,7883,3441,4442,2000
Tamaulipas,90 a 94 años,3307,1409,1898,2000
Tamaulipas,95 a 99 años,1680,727,953,2000
Tamaulipas,100 años y más,429,179,250,2000
Tamaulipas,No especificado,29599,15217,14382,2000
Tlaxcala,0 a 4 años,108862,55386,53476,2000
Tlaxcala,5 a 9 años,115925,58718,57207,2000
Tlaxcala,10 a 14 años,110488,56118,54370,2000
Tlaxcala,15 a 19 años,106450,52418,54032,2000
Tlaxcala,20 a 24 años,95999,45652,50347,2000
Tlaxcala,25 a 29 años,79360,37296,42064,2000
Tlaxcala,30 a 34 años,69785,32599,37186,2000
Tlaxcala,35 a 39 años,61295,28977,32318,2000
Tlaxcala,40 a 44 años,48701,23243,25458,2000
Tlaxcala,45 a 49 años,36434,17540,18894,2000
Tlaxcala,50 a 54 años,29923,14389,15534,2000
Tlaxcala,55 a 59 años,22869,11097,11772,2000
Tlaxcala,60 a 64 años,20010,9496,10514,2000
Tlaxcala,65 a 69 años,16582,7743,8839,2000
Tlaxcala,70 a 74 años,12377,6038,6339,2000
Tlaxcala,75 a 79 años,9585,4700,4885,2000
Tlaxcala,80 a 84 años,5308,2544,2764,2000
Tlaxcala,85 a 89 años,3366,1531,1835,2000
Tlaxcala,90 a 94 años,1392,623,769,2000
Tlaxcala,95 a 99 años,828,361,467,2000
Tlaxcala,100 años y más,200,68,132,2000
Tlaxcala,No especificado,6907,3411,3496,2000
Veracruz de Ignacio de la Llave,0 a 4 años,728473,369566,358907,2000
Veracruz de Ignacio de la Llave,5 a 9 años,812674,412270,400404,2000
Veracruz de Ignacio de la Llave,10 a 14 años,797328,404351,392977,2000
Veracruz de Ignacio de la Llave,15 a 19 años,709056,349083,359973,2000
Veracruz de Ignacio de la Llave,20 a 24 años,593263,274257,319006,2000
Veracruz de Ignacio de la Llave,25 a 29 años,536397,246494,289903,2000
Veracruz de Ignacio de la Llave,30 a 34 años,498825,233227,265598,2000
Veracruz de Ignacio de la Llave,35 a 39 años,459768,217408,242360,2000
Veracruz de Ignacio de la Llave,40 a 44 años,380702,181477,199225,2000
Veracruz de Ignacio de la Llave,45 a 49 años,312790,149441,163349,2000
Veracruz de Ignacio de la Llave,50 a 54 años,259882,125663,134219,2000
Veracruz de Ignacio de la Llave,55 a 59 años,205722,99382,106340,2000
Veracruz de Ignacio de la Llave,60 a 64 años,178582,85264,93318,2000
Veracruz de Ignacio de la Llave,65 a 69 años,132984,62339,70645,2000
Veracruz de Ignacio de la Llave,70 a 74 años,97101,46706,50395,2000
Veracruz de Ignacio de la Llave,75 a 79 años,66604,32117,34487,2000
Veracruz de Ignacio de la Llave,80 a 84 años,36758,16776,19982,2000
Veracruz de Ignacio de la Llave,85 a 89 años,22336,9680,12656,2000
Veracruz de Ignacio de la Llave,90 a 94 años,9608,4171,5437,2000
Veracruz de Ignacio de la Llave,95 a 99 años,5467,2363,3104,2000
Veracruz de Ignacio de la Llave,100 años y más,2261,913,1348,2000
Veracruz de Ignacio de la Llave,No especificado,62394,32216,30178,2000
Yucatán,0 a 4 años,173213,88088,85125,2000
Yucatán,5 a 9 años,185605,93955,91650,2000
Yucatán,10 a 14 años,183581,92863,90718,2000
Yucatán,15 a 19 años,175320,86908,88412,2000
Yucatán,20 a 24 años,160339,78157,82182,2000
Yucatán,25 a 29 años,136614,65813,70801,2000
Yucatán,30 a 34 años,114882,55218,59664,2000
Yucatán,35 a 39 años,104381,50181,54200,2000
Yucatán,40 a 44 años,87383,42447,44936,2000
Yucatán,45 a 49 años,74855,36168,38687,2000
Yucatán,50 a 54 años,63846,31152,32694,2000
Yucatán,55 a 59 años,47242,22922,24320,2000
Yucatán,60 a 64 años,40706,19687,21019,2000
Yucatán,65 a 69 años,31712,15476,16236,2000
Yucatán,70 a 74 años,24429,12129,12300,2000
Yucatán,75 a 79 años,19372,9775,9597,2000
Yucatán,80 a 84 años,12282,5991,6291,2000
Yucatán,85 a 89 años,6478,3108,3370,2000
Yucatán,90 a 94 años,2419,1138,1281,2000
Yucatán,95 a 99 años,1007,463,544,2000
Yucatán,100 años y más,230,107,123,2000
Yucatán,No especificado,12314,6459,5855,2000
Zacatecas,0 a 4 años,156356,79468,76888,2000
Zacatecas,5 a 9 años,164225,83334,80891,2000
Zacatecas,10 a 14 años,171383,86962,84421,2000
Zacatecas,15 a 19 años,145464,69249,76215,2000
Zacatecas,20 a 24 años,119820,53411,66409,2000
Zacatecas,25 a 29 años,101757,46340,55417,2000
Zacatecas,30 a 34 años,91476,41919,49557,2000
Zacatecas,35 a 39 años,79770,37063,42707,2000
Zacatecas,40 a 44 años,64510,30278,34232,2000
Zacatecas,45 a 49 años,50907,24127,26780,2000
Zacatecas,50 a 54 años,44565,21278,23287,2000
Zacatecas,55 a 59 años,37283,18116,19167,2000
Zacatecas,60 a 64 años,33857,16374,17483,2000
Zacatecas,65 a 69 años,27493,13503,13990,2000
Zacatecas,70 a 74 años,22021,11141,10880,2000
Zacatecas,75 a 79 años,15781,8007,7774,2000
Zacatecas,80 a 84 años,8519,4126,4393,2000
Zacatecas,85 a 89 años,5780,2746,3034,2000
Zacatecas,90 a 94 años,2522,1162,1360,2000
Zacatecas,95 a 99 años,1331,589,742,2000
Zacatecas,100 años y más,260,110,150,2000
Zacatecas,No especificado,8530,4280,4250,2000
Estados Unidos Mexicanos,0 a 4 años,10186243,5175913,5010330,2005
Estados Unidos Mexicanos,5 a 9 años,10511738,5339127,5172611,2005
Estados Unidos Mexicanos,10 a 14 años,10952123,5545910,5406213,2005
Estados Unidos Mexicanos,15 a 19 años,10109021,4995906,5113115,2005
Estados Unidos Mexicanos,20 a 24 años,8964629,4253440,4711189,2005
Estados Unidos Mexicanos,25 a 29 años,8103358,3805724,4297634,2005
Estados Unidos Mexicanos,30 a 34 años,7933951,3745974,4187977,2005
Estados Unidos Mexicanos,35 a 39 años,7112526,3371372,3741154,2005
Estados Unidos Mexicanos,40 a 44 años,6017268,2871549,3145719,2005
Estados Unidos Mexicanos,45 a 49 años,5015255,2388149,2627106,2005
Estados Unidos Mexicanos,50 a 54 años,4090650,1959720,2130930,2005
Estados Unidos Mexicanos,55 a 59 años,3117071,1497981,1619090,2005
Estados Unidos Mexicanos,60 a 64 años,2622476,1243788,1378688,2005
Estados Unidos Mexicanos,65 a 69 años,1958069,922592,1035477,2005
Estados Unidos Mexicanos,70 a 74 años,1496691,703277,793414,2005
Estados Unidos Mexicanos,75 a 79 años,1048315,490840,557475,2005
Estados Unidos Mexicanos,80 a 84 años,657011,296351,360660,2005
Estados Unidos Mexicanos,85 a 89 años,345154,150617,194537,2005
Estados Unidos Mexicanos,90 a 94 años,132325,54391,77934,2005
Estados Unidos Mexicanos,95 a 99 años,61145,24439,36706,2005
Estados Unidos Mexicanos,100 años y más,17649,6696,10953,2005
Estados Unidos Mexicanos,No especificado,2810720,1406199,1404521,2005
Aguascalientes,0 a 4 años,118536,60406,58130,2005
Aguascalientes,5 a 9 años,120130,60900,59230,2005
Aguascalientes,10 a 14 años,120280,60816,59464,2005
Aguascalientes,15 a 19 años,107007,52748,54259,2005
Aguascalientes,20 a 24 años,93139,43716,49423,2005
Aguascalientes,25 a 29 años,83073,38437,44636,2005
Aguascalientes,30 a 34 años,82651,38373,44278,2005
Aguascalientes,35 a 39 años,73006,34068,38938,2005
Aguascalientes,40 a 44 años,61553,29044,32509,2005
Aguascalientes,45 a 49 años,49233,23155,26078,2005
Aguascalientes,50 a 54 años,39222,18636,20586,2005
Aguascalientes,55 a 59 años,29196,13802,15394,2005
Aguascalientes,60 a 64 años,23168,10959,12209,2005
Aguascalientes,65 a 69 años,16290,7509,8781,2005
Aguascalientes,70 a 74 años,12912,5935,6977,2005
Aguascalientes,75 a 79 años,9203,4193,5010,2005
Aguascalientes,80 a 84 años,6155,2668,3487,2005
Aguascalientes,85 a 89 años,3140,1384,1756,2005
Aguascalientes,90 a 94 años,1302,542,760,2005
Aguascalientes,95 a 99 años,503,197,306,2005
Aguascalientes,100 años y más,98,41,57,2005
Aguascalientes,No especificado,15619,7835,7784,2005
Baja California,0 a 4 años,267954,136245,131709,2005
Baja California,5 a 9 años,277635,141538,136097,2005
Baja California,10 a 14 años,267938,136669,131269,2005
Baja California,15 a 19 años,255309,129298,126011,2005
Baja California,20 a 24 años,246968,123808,123160,2005
Baja California,25 a 29 años,241951,120390,121561,2005
Baja California,30 a 34 años,240879,121987,118892,2005
Baja California,35 a 39 años,208125,106746,101379,2005
Baja California,40 a 44 años,164598,83803,80795,2005
Baja California,45 a 49 años,128512,64198,64314,2005
Baja California,50 a 54 años,99356,49179,50177,2005
Baja California,55 a 59 años,71624,35077,36547,2005
Baja California,60 a 64 años,56711,27276,29435,2005
Baja California,65 a 69 años,40660,19468,21192,2005
Baja California,70 a 74 años,28923,13866,15057,2005
Baja California,75 a 79 años,18815,8983,9832,2005
Baja California,80 a 84 años,11375,5240,6135,2005
Baja California,85 a 89 años,5453,2363,3090,2005
Baja California,90 a 94 años,1987,717,1270,2005
Baja California,95 a 99 años,792,274,518,2005
Baja California,100 años y más,172,58,114,2005
Baja California,No especificado,208732,104606,104126,2005
Baja California Sur,0 a 4 años,49069,25004,24065,2005
Baja California Sur,5 a 9 años,49164,25216,23948,2005
Baja California Sur,10 a 14 años,48106,24492,23614,2005
Baja California Sur,15 a 19 años,46700,24156,22544,2005
Baja California Sur,20 a 24 años,46222,23777,22445,2005
Baja California Sur,25 a 29 años,45939,23376,22563,2005
Baja California Sur,30 a 34 años,43628,22203,21425,2005
Baja California Sur,35 a 39 años,38197,19506,18691,2005
Baja California Sur,40 a 44 años,31526,15928,15598,2005
Baja California Sur,45 a 49 años,25121,12756,12365,2005
Baja California Sur,50 a 54 años,19430,10087,9343,2005
Baja California Sur,55 a 59 años,13781,7152,6629,2005
Baja California Sur,60 a 64 años,10783,5510,5273,2005
Baja California Sur,65 a 69 años,7544,3848,3696,2005
Baja California Sur,70 a 74 años,5254,2626,2628,2005
Baja California Sur,75 a 79 años,3488,1706,1782,2005
Baja California Sur,80 a 84 años,2154,992,1162,2005
Baja California Sur,85 a 89 años,1168,483,685,2005
Baja California Sur,90 a 94 años,440,160,280,2005
Baja California Sur,95 a 99 años,177,76,101,2005
Baja California Sur,100 años y más,45,18,27,2005
Baja California Sur,No especificado,24234,12216,12018,2005
Campeche,0 a 4 años,73461,37327,36134,2005
Campeche,5 a 9 años,79199,40040,39159,2005
Campeche,10 a 14 años,83597,42346,41251,2005
Campeche,15 a 19 años,77485,38458,39027,2005
Campeche,20 a 24 años,70006,33347,36659,2005
Campeche,25 a 29 años,62455,29579,32876,2005
Campeche,30 a 34 años,59665,28481,31184,2005
Campeche,35 a 39 años,52899,25770,27129,2005
Campeche,40 a 44 años,43896,21696,22200,2005
Campeche,45 a 49 años,36152,17881,18271,2005
Campeche,50 a 54 años,29746,14818,14928,2005
Campeche,55 a 59 años,21475,10823,10652,2005
Campeche,60 a 64 años,17979,9081,8898,2005
Campeche,65 a 69 años,12827,6339,6488,2005
Campeche,70 a 74 años,9830,5097,4733,2005
Campeche,75 a 79 años,7153,3780,3373,2005
Campeche,80 a 84 años,4407,2250,2157,2005
Campeche,85 a 89 años,2579,1333,1246,2005
Campeche,90 a 94 años,890,451,439,2005
Campeche,95 a 99 años,405,234,171,2005
Campeche,100 años y más,140,73,67,2005
Campeche,No especificado,8484,4253,4231,2005
Coahuila de Zaragoza,0 a 4 años,249590,126956,122634,2005
Coahuila de Zaragoza,5 a 9 años,257277,130816,126461,2005
Coahuila de Zaragoza,10 a 14 años,257591,130729,126862,2005
Coahuila de Zaragoza,15 a 19 años,231405,116757,114648,2005
Coahuila de Zaragoza,20 a 24 años,214562,107233,107329,2005
Coahuila de Zaragoza,25 a 29 años,206859,101494,105365,2005
Coahuila de Zaragoza,30 a 34 años,205193,99340,105853,2005
Coahuila de Zaragoza,35 a 39 años,180228,87416,92812,2005
Coahuila de Zaragoza,40 a 44 años,152496,74035,78461,2005
Coahuila de Zaragoza,45 a 49 años,126257,61359,64898,2005
Coahuila de Zaragoza,50 a 54 años,100907,49273,51634,2005
Coahuila de Zaragoza,55 a 59 años,77889,38342,39547,2005
Coahuila de Zaragoza,60 a 64 años,64043,30923,33120,2005
Coahuila de Zaragoza,65 a 69 años,47679,22958,24721,2005
Coahuila de Zaragoza,70 a 74 años,34186,16539,17647,2005
Coahuila de Zaragoza,75 a 79 años,23529,11268,12261,2005
Coahuila de Zaragoza,80 a 84 años,13768,6248,7520,2005
Coahuila de Zaragoza,85 a 89 años,6882,3081,3801,2005
Coahuila de Zaragoza,90 a 94 años,2396,967,1429,2005
Coahuila de Zaragoza,95 a 99 años,1056,393,663,2005
Coahuila de Zaragoza,100 años y más,225,84,141,2005
Coahuila de Zaragoza,No especificado,41182,20669,20513,2005
Colima,0 a 4 años,51929,26388,25541,2005
Colima,5 a 9 años,53742,27734,26008,2005
Colima,10 a 14 años,56990,29280,27710,2005
Colima,15 a 19 años,56534,28076,28458,2005
Colima,20 a 24 años,50049,24135,25914,2005
Colima,25 a 29 años,44660,21164,23496,2005
Colima,30 a 34 años,44016,21077,22939,2005
Colima,35 a 39 años,39605,18850,20755,2005
Colima,40 a 44 años,34968,16970,17998,2005
Colima,45 a 49 años,28969,14171,14798,2005
Colima,50 a 54 años,23348,11439,11909,2005
Colima,55 a 59 años,17614,8732,8882,2005
Colima,60 a 64 años,14442,7075,7367,2005
Colima,65 a 69 años,10530,5110,5420,2005
Colima,70 a 74 años,7947,3836,4111,2005
Colima,75 a 79 años,5679,2765,2914,2005
Colima,80 a 84 años,3908,1821,2087,2005
Colima,85 a 89 años,2327,1060,1267,2005
Colima,90 a 94 años,946,435,511,2005
Colima,95 a 99 años,416,183,233,2005
Colima,100 años y más,121,61,60,2005
Colima,No especificado,19256,9643,9613,2005
Chiapas,0 a 4 años,490058,248713,241345,2005
Chiapas,5 a 9 años,512440,260077,252363,2005
Chiapas,10 a 14 años,537725,271971,265754,2005
Chiapas,15 a 19 años,471331,230408,240923,2005
Chiapas,20 a 24 años,383455,179238,204217,2005
Chiapas,25 a 29 años,324289,150453,173836,2005
Chiapas,30 a 34 años,283522,132962,150560,2005
Chiapas,35 a 39 años,257320,121598,135722,2005
Chiapas,40 a 44 años,210437,102657,107780,2005
Chiapas,45 a 49 años,176142,86422,89720,2005
Chiapas,50 a 54 años,139301,69845,69456,2005
Chiapas,55 a 59 años,103667,51992,51675,2005
Chiapas,60 a 64 años,98728,48847,49881,2005
Chiapas,65 a 69 años,63469,31538,31931,2005
Chiapas,70 a 74 años,46845,24124,22721,2005
Chiapas,75 a 79 años,31858,16440,15418,2005
Chiapas,80 a 84 años,19141,9728,9413,2005
Chiapas,85 a 89 años,10593,5355,5238,2005
Chiapas,90 a 94 años,4097,1993,2104,2005
Chiapas,95 a 99 años,2352,1175,1177,2005
Chiapas,100 años y más,1267,615,652,2005
Chiapas,No especificado,125422,62679,62743,2005
Chihuahua,0 a 4 años,320384,162947,157437,2005
Chihuahua,5 a 9 años,324350,164698,159652,2005
Chihuahua,10 a 14 años,322642,163733,158909,2005
Chihuahua,15 a 19 años,300186,151797,148389,2005
Chihuahua,20 a 24 años,267506,133526,133980,2005
Chihuahua,25 a 29 años,250016,123385,126631,2005
Chihuahua,30 a 34 años,257676,127117,130559,2005
Chihuahua,35 a 39 años,233533,114930,118603,2005
Chihuahua,40 a 44 años,193322,94501,98821,2005
Chihuahua,45 a 49 años,153968,74445,79523,2005
Chihuahua,50 a 54 años,119550,57774,61776,2005
Chihuahua,55 a 59 años,92987,44511,48476,2005
Chihuahua,60 a 64 años,80050,38234,41816,2005
Chihuahua,65 a 69 años,62659,30067,32592,2005
Chihuahua,70 a 74 años,45078,21842,23236,2005
Chihuahua,75 a 79 años,29983,14348,15635,2005
Chihuahua,80 a 84 años,17235,7908,9327,2005
Chihuahua,85 a 89 años,8045,3564,4481,2005
Chihuahua,90 a 94 años,2931,1158,1773,2005
Chihuahua,95 a 99 años,1078,400,678,2005
Chihuahua,100 años y más,224,90,134,2005
Chihuahua,No especificado,158041,79300,78741,2005
Ciudad de México,0 a 4 años,664092,338207,325885,2005
Ciudad de México,5 a 9 años,671579,341618,329961,2005
Ciudad de México,10 a 14 años,704950,357106,347844,2005
Ciudad de México,15 a 19 años,740280,368042,372238,2005
Ciudad de México,20 a 24 años,765641,373044,392597,2005
Ciudad de México,25 a 29 años,735441,353337,382104,2005
Ciudad de México,30 a 34 años,755600,359952,395648,2005
Ciudad de México,35 a 39 años,678990,319519,359471,2005
Ciudad de México,40 a 44 años,596540,278656,317884,2005
Ciudad de México,45 a 49 años,515878,237757,278121,2005
Ciudad de México,50 a 54 años,441077,202356,238721,2005
Ciudad de México,55 a 59 años,329553,150909,178644,2005
Ciudad de México,60 a 64 años,263228,117398,145830,2005
Ciudad de México,65 a 69 años,192699,83931,108768,2005
Ciudad de México,70 a 74 años,164150,67932,96218,2005
Ciudad de México,75 a 79 años,110512,44280,66232,2005
Ciudad de México,80 a 84 años,72725,27752,44973,2005
Ciudad de México,85 a 89 años,35912,12752,23160,2005
Ciudad de México,90 a 94 años,14084,4564,9520,2005
Ciudad de México,95 a 99 años,5176,1589,3587,2005
Ciudad de México,100 años y más,952,254,698,2005
Ciudad de México,No especificado,261857,130728,131129,2005
Durango,0 a 4 años,158588,80812,77776,2005
Durango,5 a 9 años,165488,84071,81417,2005
Durango,10 a 14 años,171314,86908,84406,2005
Durango,15 a 19 años,156434,77795,78639,2005
Durango,20 a 24 años,124920,59372,65548,2005
Durango,25 a 29 años,111556,52329,59227,2005
Durango,30 a 34 años,110058,51803,58255,2005
Durango,35 a 39 años,99365,46784,52581,2005
Durango,40 a 44 años,85571,40303,45268,2005
Durango,45 a 49 años,70558,33419,37139,2005
Durango,50 a 54 años,57570,27707,29863,2005
Durango,55 a 59 años,45386,21832,23554,2005
Durango,60 a 64 años,40026,19550,20476,2005
Durango,65 a 69 años,31835,15693,16142,2005
Durango,70 a 74 años,24425,12125,12300,2005
Durango,75 a 79 años,16824,8396,8428,2005
Durango,80 a 84 años,9837,4828,5009,2005
Durango,85 a 89 años,4700,2165,2535,2005
Durango,90 a 94 años,1784,813,971,2005
Durango,95 a 99 años,798,346,452,2005
Durango,100 años y más,243,104,139,2005
Durango,No especificado,21837,10940,10897,2005
Guanajuato,0 a 4 años,527480,267399,260081,2005
Guanajuato,5 a 9 años,551459,279081,272378,2005
Guanajuato,10 a 14 años,569357,286789,282568,2005
Guanajuato,15 a 19 años,504643,241953,262690,2005
Guanajuato,20 a 24 años,425409,188993,236416,2005
Guanajuato,25 a 29 años,377109,167451,209658,2005
Guanajuato,30 a 34 años,361384,163437,197947,2005
Guanajuato,35 a 39 años,321689,147170,174519,2005
Guanajuato,40 a 44 años,269592,124556,145036,2005
Guanajuato,45 a 49 años,219520,102288,117232,2005
Guanajuato,50 a 54 años,180011,84056,95955,2005
Guanajuato,55 a 59 años,135455,64147,71308,2005
Guanajuato,60 a 64 años,117552,54792,62760,2005
Guanajuato,65 a 69 años,87450,41027,46423,2005
Guanajuato,70 a 74 años,71388,33672,37716,2005
Guanajuato,75 a 79 años,51797,24481,27316,2005
Guanajuato,80 a 84 años,34405,15638,18767,2005
Guanajuato,85 a 89 años,17077,7610,9467,2005
Guanajuato,90 a 94 años,7351,3125,4226,2005
Guanajuato,95 a 99 años,3392,1396,1996,2005
Guanajuato,100 años y más,754,269,485,2005
Guanajuato,No especificado,59538,29806,29732,2005
Guerrero,0 a 4 años,345731,174968,170763,2005
Guerrero,5 a 9 años,377826,190749,187077,2005
Guerrero,10 a 14 años,396125,200491,195634,2005
Guerrero,15 a 19 años,332940,161667,171273,2005
Guerrero,20 a 24 años,252404,114723,137681,2005
Guerrero,25 a 29 años,212665,96552,116113,2005
Guerrero,30 a 34 años,198099,90739,107360,2005
Guerrero,35 a 39 años,181518,83257,98261,2005
Guerrero,40 a 44 años,158810,74032,84778,2005
Guerrero,45 a 49 años,135306,63531,71775,2005
Guerrero,50 a 54 años,112818,53978,58840,2005
Guerrero,55 a 59 años,89468,42807,46661,2005
Guerrero,60 a 64 años,80235,37731,42504,2005
Guerrero,65 a 69 años,66040,30398,35642,2005
Guerrero,70 a 74 años,50403,23852,26551,2005
Guerrero,75 a 79 años,34974,16891,18083,2005
Guerrero,80 a 84 años,21597,9992,11605,2005
Guerrero,85 a 89 años,11675,5335,6340,2005
Guerrero,90 a 94 años,4612,2040,2572,2005
Guerrero,95 a 99 años,2520,1130,1390,2005
Guerrero,100 años y más,1126,486,640,2005
Guerrero,No especificado,48310,24104,24206,2005
Hidalgo,0 a 4 años,237423,120784,116639,2005
Hidalgo,5 a 9 años,243185,123336,119849,2005
Hidalgo,10 a 14 años,270650,136955,133695,2005
Hidalgo,15 a 19 años,237675,115331,122344,2005
Hidalgo,20 a 24 años,196494,88134,108360,2005
Hidalgo,25 a 29 años,175226,78011,97215,2005
Hidalgo,30 a 34 años,173306,78284,95022,2005
Hidalgo,35 a 39 años,159174,73325,85849,2005
Hidalgo,40 a 44 años,135441,63506,71935,2005
Hidalgo,45 a 49 años,116547,55512,61035,2005
Hidalgo,50 a 54 años,93857,45771,48086,2005
Hidalgo,55 a 59 años,73161,35672,37489,2005
Hidalgo,60 a 64 años,65005,31058,33947,2005
Hidalgo,65 a 69 años,46738,22345,24393,2005
Hidalgo,70 a 74 años,35516,16901,18615,2005
Hidalgo,75 a 79 años,25653,12155,13498,2005
Hidalgo,80 a 84 años,16502,7413,9089,2005
Hidalgo,85 a 89 años,9117,3974,5143,2005
Hidalgo,90 a 94 años,3470,1381,2089,2005
Hidalgo,95 a 99 años,1703,628,1075,2005
Hidalgo,100 años y más,621,204,417,2005
Hidalgo,No especificado,29050,14508,14542,2005
Jalisco,0 a 4 años,674285,342642,331643,2005
Jalisco,5 a 9 años,688681,349996,338685,2005
Jalisco,10 a 14 años,697206,354242,342964,2005
Jalisco,15 a 19 años,669724,330944,338780,2005
Jalisco,20 a 24 años,601671,285876,315795,2005
Jalisco,25 a 29 años,523866,246599,277267,2005
Jalisco,30 a 34 años,509541,240566,268975,2005
Jalisco,35 a 39 años,448698,211444,237254,2005
Jalisco,40 a 44 años,379829,179031,200798,2005
Jalisco,45 a 49 años,318734,149555,169179,2005
Jalisco,50 a 54 años,267921,125979,141942,2005
Jalisco,55 a 59 años,208005,99191,108814,2005
Jalisco,60 a 64 años,172579,81797,90782,2005
Jalisco,65 a 69 años,126101,59336,66765,2005
Jalisco,70 a 74 años,96044,44817,51227,2005
Jalisco,75 a 79 años,69383,32186,37197,2005
Jalisco,80 a 84 años,48147,21475,26672,2005
Jalisco,85 a 89 años,27217,12006,15211,2005
Jalisco,90 a 94 años,11502,4926,6576,2005
Jalisco,95 a 99 años,4526,1778,2748,2005
Jalisco,100 años y más,1027,409,618,2005
Jalisco,No especificado,207426,104027,103399,2005
México,0 a 4 años,1373064,697889,675175,2005
México,5 a 9 años,1362065,691997,670068,2005
México,10 a 14 años,1410691,713138,697553,2005
México,15 a 19 años,1334112,663064,671048,2005
México,20 a 24 años,1250151,601037,649114,2005
México,25 a 29 años,1152407,546014,606393,2005
México,30 a 34 años,1147320,541872,605448,2005
México,35 a 39 años,1016457,483846,532611,2005
México,40 a 44 años,839324,402414,436910,2005
México,45 a 49 años,682173,325717,356456,2005
México,50 a 54 años,539308,259710,279598,2005
México,55 a 59 años,388919,187632,201287,2005
México,60 a 64 años,305945,145437,160508,2005
México,65 a 69 años,215924,100467,115457,2005
México,70 a 74 años,156324,71808,84516,2005
México,75 a 79 años,102977,46177,56800,2005
México,80 a 84 años,61530,26388,35142,2005
México,85 a 89 años,31282,12505,18777,2005
México,90 a 94 años,11029,3929,7100,2005
México,95 a 99 años,5264,1772,3492,2005
México,100 años y más,1334,376,958,2005
México,No especificado,619895,309633,310262,2005
Michoacán de Ocampo,0 a 4 años,400054,202915,197139,2005
Michoacán de Ocampo,5 a 9 años,426654,215699,210955,2005
Michoacán de Ocampo,10 a 14 años,462479,233342,229137,2005
Michoacán de Ocampo,15 a 19 años,423624,202977,220647,2005
Michoacán de Ocampo,20 a 24 años,332440,147596,184844,2005
Michoacán de Ocampo,25 a 29 años,284690,126561,158129,2005
Michoacán de Ocampo,30 a 34 años,273154,124017,149137,2005
Michoacán de Ocampo,35 a 39 años,247470,112596,134874,2005
Michoacán de Ocampo,40 a 44 años,216455,100356,116099,2005
Michoacán de Ocampo,45 a 49 años,182586,85391,97195,2005
Michoacán de Ocampo,50 a 54 años,153673,72818,80855,2005
Michoacán de Ocampo,55 a 59 años,120402,57263,63139,2005
Michoacán de Ocampo,60 a 64 años,104898,49077,55821,2005
Michoacán de Ocampo,65 a 69 años,84325,39858,44467,2005
Michoacán de Ocampo,70 a 74 años,69195,32843,36352,2005
Michoacán de Ocampo,75 a 79 años,50678,24637,26041,2005
Michoacán de Ocampo,80 a 84 años,33279,15582,17697,2005
Michoacán de Ocampo,85 a 89 años,17681,8382,9299,2005
Michoacán de Ocampo,90 a 94 años,7330,3314,4016,2005
Michoacán de Ocampo,95 a 99 años,3683,1616,2067,2005
Michoacán de Ocampo,100 años y más,1046,427,619,2005
Michoacán de Ocampo,No especificado,70277,35110,35167,2005
Morelos,0 a 4 años,150281,76612,73669,2005
Morelos,5 a 9 años,157253,79931,77322,2005
Morelos,10 a 14 años,168541,85250,83291,2005
Morelos,15 a 19 años,155301,76688,78613,2005
Morelos,20 a 24 años,134191,62002,72189,2005
Morelos,25 a 29 años,119236,54001,65235,2005
Morelos,30 a 34 años,118659,54302,64357,2005
Morelos,35 a 39 años,108333,49588,58745,2005
Morelos,40 a 44 años,94307,44081,50226,2005
Morelos,45 a 49 años,81012,37708,43304,2005
Morelos,50 a 54 años,67341,32058,35283,2005
Morelos,55 a 59 años,51112,24477,26635,2005
Morelos,60 a 64 años,43128,20379,22749,2005
Morelos,65 a 69 años,33653,15527,18126,2005
Morelos,70 a 74 años,26836,12445,14391,2005
Morelos,75 a 79 años,19198,9080,10118,2005
Morelos,80 a 84 años,11620,5406,6214,2005
Morelos,85 a 89 años,5851,2574,3277,2005
Morelos,90 a 94 años,2162,909,1253,2005
Morelos,95 a 99 años,1104,452,652,2005
Morelos,100 años y más,390,157,233,2005
Morelos,No especificado,63390,31684,31706,2005
Nayarit,0 a 4 años,92384,46895,45489,2005
Nayarit,5 a 9 años,96834,49627,47207,2005
Nayarit,10 a 14 años,103122,52426,50696,2005
Nayarit,15 a 19 años,97519,48922,48597,2005
Nayarit,20 a 24 años,79031,37566,41465,2005
Nayarit,25 a 29 años,69847,33028,36819,2005
Nayarit,30 a 34 años,69251,33146,36105,2005
Nayarit,35 a 39 años,62553,30053,32500,2005
Nayarit,40 a 44 años,54176,26110,28066,2005
Nayarit,45 a 49 años,47294,22809,24485,2005
Nayarit,50 a 54 años,39727,19578,20149,2005
Nayarit,55 a 59 años,31623,15747,15876,2005
Nayarit,60 a 64 años,27893,13971,13922,2005
Nayarit,65 a 69 años,21551,10898,10653,2005
Nayarit,70 a 74 años,15830,8126,7704,2005
Nayarit,75 a 79 años,11271,5622,5649,2005
Nayarit,80 a 84 años,7228,3538,3690,2005
Nayarit,85 a 89 años,4184,1991,2193,2005
Nayarit,90 a 94 años,1694,790,904,2005
Nayarit,95 a 99 años,788,378,410,2005
Nayarit,100 años y más,222,109,113,2005
Nayarit,No especificado,15662,7874,7788,2005
Nuevo León,0 a 4 años,396832,202457,194375,2005
Nuevo León,5 a 9 años,403641,205432,198209,2005
Nuevo León,10 a 14 años,381498,193885,187613,2005
Nuevo León,15 a 19 años,372986,187600,185386,2005
Nuevo León,20 a 24 años,381072,191558,189514,2005
Nuevo León,25 a 29 años,364392,181145,183247,2005
Nuevo León,30 a 34 años,368549,183158,185391,2005
Nuevo León,35 a 39 años,322812,159879,162933,2005
Nuevo León,40 a 44 años,265277,131231,134046,2005
Nuevo León,45 a 49 años,218683,106900,111783,2005
Nuevo León,50 a 54 años,172436,83952,88484,2005
Nuevo León,55 a 59 años,134046,65124,68922,2005
Nuevo León,60 a 64 años,108646,52394,56252,2005
Nuevo León,65 a 69 años,83083,39917,43166,2005
Nuevo León,70 a 74 años,59373,27965,31408,2005
Nuevo León,75 a 79 años,40397,18477,21920,2005
Nuevo León,80 a 84 años,24628,10827,13801,2005
Nuevo León,85 a 89 años,11929,5007,6922,2005
Nuevo León,90 a 94 años,4738,1787,2951,2005
Nuevo León,95 a 99 años,1817,709,1108,2005
Nuevo León,100 años y más,376,143,233,2005
Nuevo León,No especificado,82081,41126,40955,2005
Oaxaca,0 a 4 años,357272,180883,176389,2005
Oaxaca,5 a 9 años,394779,199744,195035,2005
Oaxaca,10 a 14 años,443980,223625,220355,2005
Oaxaca,15 a 19 años,366868,178035,188833,2005
Oaxaca,20 a 24 años,281999,127254,154745,2005
Oaxaca,25 a 29 años,243386,108120,135266,2005
Oaxaca,30 a 34 años,230648,104049,126599,2005
Oaxaca,35 a 39 años,210256,95780,114476,2005
Oaxaca,40 a 44 años,185440,86072,99368,2005
Oaxaca,45 a 49 años,161350,74758,86592,2005
Oaxaca,50 a 54 años,136431,64181,72250,2005
Oaxaca,55 a 59 años,107316,50555,56761,2005
Oaxaca,60 a 64 años,102856,47633,55223,2005
Oaxaca,65 a 69 años,77317,35777,41540,2005
Oaxaca,70 a 74 años,61759,29226,32533,2005
Oaxaca,75 a 79 años,44826,21403,23423,2005
Oaxaca,80 a 84 años,29144,13547,15597,2005
Oaxaca,85 a 89 años,15726,7149,8577,2005
Oaxaca,90 a 94 años,5751,2498,3253,2005
Oaxaca,95 a 99 años,2870,1217,1653,2005
Oaxaca,100 años y más,992,365,627,2005
Oaxaca,No especificado,45855,22984,22871,2005
Puebla,0 a 4 años,579804,293977,285827,2005
Puebla,5 a 9 años,586108,297066,289042,2005
Puebla,10 a 14 años,624075,314797,309278,2005
Puebla,15 a 19 años,548971,268014,280957,2005
Puebla,20 a 24 años,474429,217540,256889,2005
Puebla,25 a 29 años,411939,187990,223949,2005
Puebla,30 a 34 años,384349,176534,207815,2005
Puebla,35 a 39 años,340799,156674,184125,2005
Puebla,40 a 44 años,283374,132012,151362,2005
Puebla,45 a 49 años,242420,112766,129654,2005
Puebla,50 a 54 años,197862,92385,105477,2005
Puebla,55 a 59 años,154041,71906,82135,2005
Puebla,60 a 64 años,133552,61586,71966,2005
Puebla,65 a 69 años,100862,46020,54842,2005
Puebla,70 a 74 años,78396,35821,42575,2005
Puebla,75 a 79 años,58514,26859,31655,2005
Puebla,80 a 84 años,36177,16005,20172,2005
Puebla,85 a 89 años,20730,8886,11844,2005
Puebla,90 a 94 años,7209,2908,4301,2005
Puebla,95 a 99 años,3919,1408,2511,2005
Puebla,100 años y más,1187,373,814,2005
Puebla,No especificado,114416,57137,57279,2005
Querétaro,0 a 4 años,162841,82781,80060,2005
Querétaro,5 a 9 años,168900,85804,83096,2005
Querétaro,10 a 14 años,178589,89895,88694,2005
Querétaro,15 a 19 años,162541,79047,83494,2005
Querétaro,20 a 24 años,146713,68013,78700,2005
Querétaro,25 a 29 años,130500,60021,70479,2005
Querétaro,30 a 34 años,126438,59116,67322,2005
Querétaro,35 a 39 años,109689,51435,58254,2005
Querétaro,40 a 44 años,91576,43747,47829,2005
Querétaro,45 a 49 años,73238,35138,38100,2005
Querétaro,50 a 54 años,57129,27531,29598,2005
Querétaro,55 a 59 años,40621,19600,21021,2005
Querétaro,60 a 64 años,33692,15806,17886,2005
Querétaro,65 a 69 años,24520,11554,12966,2005
Querétaro,70 a 74 años,18292,8548,9744,2005
Querétaro,75 a 79 años,13166,6057,7109,2005
Querétaro,80 a 84 años,8367,3739,4628,2005
Querétaro,85 a 89 años,4475,1851,2624,2005
Querétaro,90 a 94 años,1700,641,1059,2005
Querétaro,95 a 99 años,840,315,525,2005
Querétaro,100 años y más,184,65,119,2005
Querétaro,No especificado,44128,22055,22073,2005
Quintana Roo,0 a 4 años,107380,54437,52943,2005
Quintana Roo,5 a 9 años,106802,54551,52251,2005
Quintana Roo,10 a 14 años,106745,54091,52654,2005
Quintana Roo,15 a 19 años,102042,51828,50214,2005
Quintana Roo,20 a 24 años,103377,52041,51336,2005
Quintana Roo,25 a 29 años,97203,48401,48802,2005
Quintana Roo,30 a 34 años,93113,46621,46492,2005
Quintana Roo,35 a 39 años,78570,39966,38604,2005
Quintana Roo,40 a 44 años,59687,30565,29122,2005
Quintana Roo,45 a 49 años,43595,22306,21289,2005
Quintana Roo,50 a 54 años,32692,16898,15794,2005
Quintana Roo,55 a 59 años,23000,11898,11102,2005
Quintana Roo,60 a 64 años,16414,8388,8026,2005
Quintana Roo,65 a 69 años,10845,5559,5286,2005
Quintana Roo,70 a 74 años,7226,3713,3513,2005
Quintana Roo,75 a 79 años,4657,2454,2203,2005
Quintana Roo,80 a 84 años,2770,1457,1313,2005
Quintana Roo,85 a 89 años,1499,754,745,2005
Quintana Roo,90 a 94 años,477,248,229,2005
Quintana Roo,95 a 99 años,205,112,93,2005
Quintana Roo,100 años y más,70,46,24,2005
Quintana Roo,No especificado,136940,68503,68437,2005
San Luis Potosí,0 a 4 años,253580,128094,125486,2005
San Luis Potosí,5 a 9 años,266312,135091,131221,2005
San Luis Potosí,10 a 14 años,285397,144282,141115,2005
San Luis Potosí,15 a 19 años,247158,121587,125571,2005
San Luis Potosí,20 a 24 años,198562,91177,107385,2005
San Luis Potosí,25 a 29 años,173849,79474,94375,2005
San Luis Potosí,30 a 34 años,171383,79159,92224,2005
San Luis Potosí,35 a 39 años,155867,72725,83142,2005
San Luis Potosí,40 a 44 años,134538,63383,71155,2005
San Luis Potosí,45 a 49 años,113281,53881,59400,2005
San Luis Potosí,50 a 54 años,92388,44537,47851,2005
San Luis Potosí,55 a 59 años,73276,35625,37651,2005
San Luis Potosí,60 a 64 años,65308,31164,34144,2005
San Luis Potosí,65 a 69 años,51272,24723,26549,2005
San Luis Potosí,70 a 74 años,40409,19645,20764,2005
San Luis Potosí,75 a 79 años,29792,14795,14997,2005
San Luis Potosí,80 a 84 años,19149,9277,9872,2005
San Luis Potosí,85 a 89 años,9094,4254,4840,2005
San Luis Potosí,90 a 94 años,3817,1670,2147,2005
San Luis Potosí,95 a 99 años,1978,831,1147,2005
San Luis Potosí,100 años y más,515,187,328,2005
San Luis Potosí,No especificado,23489,11747,11742,2005
Sinaloa,0 a 4 años,244907,124872,120035,2005
Sinaloa,5 a 9 años,262539,133821,128718,2005
Sinaloa,10 a 14 años,275179,139909,135270,2005
Sinaloa,15 a 19 años,256624,129543,127081,2005
Sinaloa,20 a 24 años,220179,108293,111886,2005
Sinaloa,25 a 29 años,196928,95435,101493,2005
Sinaloa,30 a 34 años,197089,95801,101288,2005
Sinaloa,35 a 39 años,177043,85905,91138,2005
Sinaloa,40 a 44 años,154173,74352,79821,2005
Sinaloa,45 a 49 años,130129,62475,67654,2005
Sinaloa,50 a 54 años,107972,52869,55103,2005
Sinaloa,55 a 59 años,84875,42299,42576,2005
Sinaloa,60 a 64 años,71711,36009,35702,2005
Sinaloa,65 a 69 años,53783,26831,26952,2005
Sinaloa,70 a 74 años,38183,19176,19007,2005
Sinaloa,75 a 79 años,26535,13077,13458,2005
Sinaloa,80 a 84 años,16422,7701,8721,2005
Sinaloa,85 a 89 años,9116,4071,5045,2005
Sinaloa,90 a 94 años,3405,1468,1937,2005
Sinaloa,95 a 99 años,1432,592,840,2005
Sinaloa,100 años y más,411,163,248,2005
Sinaloa,No especificado,79807,39955,39852,2005
Sonora,0 a 4 años,234936,119774,115162,2005
Sonora,5 a 9 años,243250,124307,118943,2005
Sonora,10 a 14 años,240901,122616,118285,2005
Sonora,15 a 19 años,221592,112152,109440,2005
Sonora,20 a 24 años,201924,100958,100966,2005
Sonora,25 a 29 años,190619,94060,96559,2005
Sonora,30 a 34 años,191733,95041,96692,2005
Sonora,35 a 39 años,171077,84559,86518,2005
Sonora,40 a 44 años,147464,72883,74581,2005
Sonora,45 a 49 años,125538,61981,63557,2005
Sonora,50 a 54 años,99848,49577,50271,2005
Sonora,55 a 59 años,74804,37298,37506,2005
Sonora,60 a 64 años,61504,30129,31375,2005
Sonora,65 a 69 años,48362,23795,24567,2005
Sonora,70 a 74 años,33784,16664,17120,2005
Sonora,75 a 79 años,23631,11487,12144,2005
Sonora,80 a 84 años,13538,6420,7118,2005
Sonora,85 a 89 años,6965,3022,3943,2005
Sonora,90 a 94 años,2323,920,1403,2005
Sonora,95 a 99 años,902,350,552,2005
Sonora,100 años y más,214,87,127,2005
Sonora,No especificado,59952,30074,29878,2005
Tabasco,0 a 4 años,204327,103987,100340,2005
Tabasco,5 a 9 años,208905,105980,102925,2005
Tabasco,10 a 14 años,222167,112052,110115,2005
Tabasco,15 a 19 años,210055,103853,106202,2005
Tabasco,20 a 24 años,188484,88521,99963,2005
Tabasco,25 a 29 años,166827,77246,89581,2005
Tabasco,30 a 34 años,152970,71854,81116,2005
Tabasco,35 a 39 años,139172,67085,72087,2005
Tabasco,40 a 44 años,116283,57310,58973,2005
Tabasco,45 a 49 años,94231,46877,47354,2005
Tabasco,50 a 54 años,74419,37257,37162,2005
Tabasco,55 a 59 años,53257,26778,26479,2005
Tabasco,60 a 64 años,43088,21273,21815,2005
Tabasco,65 a 69 años,32200,15783,16417,2005
Tabasco,70 a 74 años,24663,12516,12147,2005
Tabasco,75 a 79 años,16749,8456,8293,2005
Tabasco,80 a 84 años,9314,4705,4609,2005
Tabasco,85 a 89 años,5288,2583,2705,2005
Tabasco,90 a 94 años,2051,993,1058,2005
Tabasco,95 a 99 años,1228,605,623,2005
Tabasco,100 años y más,512,216,296,2005
Tabasco,No especificado,23779,11855,11924,2005
Tamaulipas,0 a 4 años,294740,149599,145141,2005
Tamaulipas,5 a 9 años,295298,150744,144554,2005
Tamaulipas,10 a 14 años,290402,147498,142904,2005
Tamaulipas,15 a 19 años,274245,138074,136171,2005
Tamaulipas,20 a 24 años,267644,131056,136588,2005
Tamaulipas,25 a 29 años,253314,122825,130489,2005
Tamaulipas,30 a 34 años,248444,120474,127970,2005
Tamaulipas,35 a 39 años,223045,108728,114317,2005
Tamaulipas,40 a 44 años,185155,90750,94405,2005
Tamaulipas,45 a 49 años,150775,73401,77374,2005
Tamaulipas,50 a 54 años,119530,58365,61165,2005
Tamaulipas,55 a 59 años,91480,43967,47513,2005
Tamaulipas,60 a 64 años,77434,36895,40539,2005
Tamaulipas,65 a 69 años,60579,28743,31836,2005
Tamaulipas,70 a 74 años,44260,21037,23223,2005
Tamaulipas,75 a 79 años,30697,14479,16218,2005
Tamaulipas,80 a 84 años,18581,8412,10169,2005
Tamaulipas,85 a 89 años,8759,3889,4870,2005
Tamaulipas,90 a 94 años,3287,1396,1891,2005
Tamaulipas,95 a 99 años,1450,605,845,2005
Tamaulipas,100 años y más,429,162,267,2005
Tamaulipas,No especificado,84690,42474,42216,2005
Tlaxcala,0 a 4 años,114954,58574,56380,2005
Tlaxcala,5 a 9 años,114239,58160,56079,2005
Tlaxcala,10 a 14 años,118450,60021,58429,2005
Tlaxcala,15 a 19 años,108254,53846,54408,2005
Tlaxcala,20 a 24 años,99680,46429,53251,2005
Tlaxcala,25 a 29 años,88678,40707,47971,2005
Tlaxcala,30 a 34 años,81874,37734,44140,2005
Tlaxcala,35 a 39 años,72699,33984,38715,2005
Tlaxcala,40 a 44 años,59577,28186,31391,2005
Tlaxcala,45 a 49 años,48794,22995,25799,2005
Tlaxcala,50 a 54 años,37925,18030,19895,2005
Tlaxcala,55 a 59 años,28757,13902,14855,2005
Tlaxcala,60 a 64 años,24137,11552,12585,2005
Tlaxcala,65 a 69 años,18889,8873,10016,2005
Tlaxcala,70 a 74 años,14576,6904,7672,2005
Tlaxcala,75 a 79 años,11317,5460,5857,2005
Tlaxcala,80 a 84 años,7232,3382,3850,2005
Tlaxcala,85 a 89 años,4171,1922,2249,2005
Tlaxcala,90 a 94 años,1502,664,838,2005
Tlaxcala,95 a 99 años,794,331,463,2005
Tlaxcala,100 años y más,188,69,119,2005
Tlaxcala,No especificado,11520,5752,5768,2005
Veracruz de Ignacio de la Llave,0 a 4 años,676902,344371,332531,2005
Veracruz de Ignacio de la Llave,5 a 9 años,720700,366110,354590,2005
Veracruz de Ignacio de la Llave,10 a 14 años,791110,401867,389243,2005
Veracruz de Ignacio de la Llave,15 a 19 años,710167,351004,359163,2005
Veracruz de Ignacio de la Llave,20 a 24 años,582248,269012,313236,2005
Veracruz de Ignacio de la Llave,25 a 29 años,517828,232501,285327,2005
Veracruz de Ignacio de la Llave,30 a 34 años,516830,234539,282291,2005
Veracruz de Ignacio de la Llave,35 a 39 años,496595,229601,266994,2005
Veracruz de Ignacio de la Llave,40 a 44 años,432692,203928,228764,2005
Veracruz de Ignacio de la Llave,45 a 49 años,369611,175365,194246,2005
Veracruz de Ignacio de la Llave,50 a 54 años,310556,148137,162419,2005
Veracruz de Ignacio de la Llave,55 a 59 años,247750,119097,128653,2005
Veracruz de Ignacio de la Llave,60 a 64 años,211512,100645,110867,2005
Veracruz de Ignacio de la Llave,65 a 69 años,159801,75256,84545,2005
Veracruz de Ignacio de la Llave,70 a 74 años,121464,57509,63955,2005
Veracruz de Ignacio de la Llave,75 a 79 años,85434,40350,45084,2005
Veracruz de Ignacio de la Llave,80 a 84 años,50171,23047,27124,2005
Veracruz de Ignacio de la Llave,85 a 89 años,27716,12147,15569,2005
Veracruz de Ignacio de la Llave,90 a 94 años,10668,4500,6168,2005
Veracruz de Ignacio de la Llave,95 a 99 años,5679,2313,3366,2005
Veracruz de Ignacio de la Llave,100 años y más,2115,817,1298,2005
Veracruz de Ignacio de la Llave,No especificado,62665,31263,31402,2005
Yucatán,0 a 4 años,169575,85966,83609,2005
Yucatán,5 a 9 años,176491,89687,86804,2005
Yucatán,10 a 14 años,188049,95354,92695,2005
Yucatán,15 a 19 años,183960,91950,92010,2005
Yucatán,20 a 24 años,171550,84185,87365,2005
Yucatán,25 a 29 años,147473,71543,75930,2005
Yucatán,30 a 34 años,139475,67053,72422,2005
Yucatán,35 a 39 años,118211,56944,61267,2005
Yucatán,40 a 44 años,103126,49655,53471,2005
Yucatán,45 a 49 años,86897,41778,45119,2005
Yucatán,50 a 54 años,76900,36800,40100,2005
Yucatán,55 a 59 años,61894,30238,31656,2005
Yucatán,60 a 64 años,48236,23013,25223,2005
Yucatán,65 a 69 años,38247,18600,19647,2005
Yucatán,70 a 74 años,28422,13928,14494,2005
Yucatán,75 a 79 años,21195,10674,10521,2005
Yucatán,80 a 84 años,14293,6968,7325,2005
Yucatán,85 a 89 años,8573,4172,4401,2005
Yucatán,90 a 94 años,2818,1289,1529,2005
Yucatán,95 a 99 años,1110,517,593,2005
Yucatán,100 años y más,182,69,113,2005
Yucatán,No especificado,32271,16179,16092,2005
Zacatecas,0 a 4 años,143830,73032,70798,2005
Zacatecas,5 a 9 años,148813,75506,73307,2005
Zacatecas,10 a 14 años,156277,79335,76942,2005
Zacatecas,15 a 19 años,145349,70292,75057,2005
Zacatecas,20 a 24 años,112509,50280,62229,2005
Zacatecas,25 a 29 años,99137,44095,55042,2005
Zacatecas,30 a 34 años,97454,45183,52271,2005
Zacatecas,35 a 39 años,89531,41641,47890,2005
Zacatecas,40 a 44 años,76065,35796,40269,2005
Zacatecas,45 a 49 años,62751,29454,33297,2005
Zacatecas,50 a 54 años,50399,24139,26260,2005
Zacatecas,55 a 59 años,40637,19586,21051,2005
Zacatecas,60 a 64 años,37993,18206,19787,2005
Zacatecas,65 a 69 años,30335,14844,15491,2005
Zacatecas,70 a 74 años,24798,12239,12559,2005
Zacatecas,75 a 79 años,18430,9424,9006,2005
Zacatecas,80 a 84 años,12212,5997,6215,2005
Zacatecas,85 a 89 años,6230,2993,3237,2005
Zacatecas,90 a 94 años,2572,1195,1377,2005
Zacatecas,95 a 99 años,1188,517,671,2005
Zacatecas,100 años y más,267,99,168,2005
Zacatecas,No especificado,10915,5480,5435,2005
Estados Unidos Mexicanos,0 a 4 años,10528322,5346943,5181379,2010
Estados Unidos Mexicanos,5 a 9 años,11047537,5604175,5443362,2010
Estados Unidos Mexicanos,10 a 14 años,10939937,5547613,5392324,2010
Estados Unidos Mexicanos,15 a 19 años,11026112,5520121,5505991,2010
Estados Unidos Mexicanos,20 a 24 años,9892271,4813204,5079067,2010
Estados Unidos Mexicanos,25 a 29 años,8788177,4205975,4582202,2010
Estados Unidos Mexicanos,30 a 34 años,8470798,4026031,4444767,2010
Estados Unidos Mexicanos,35 a 39 años,8292987,3964738,4328249,2010
Estados Unidos Mexicanos,40 a 44 años,7009226,3350322,3658904,2010
Estados Unidos Mexicanos,45 a 49 años,5928730,2824364,3104366,2010
Estados Unidos Mexicanos,50 a 54 años,5064291,2402451,2661840,2010
Estados Unidos Mexicanos,55 a 59 años,3895365,1869537,2025828,2010
Estados Unidos Mexicanos,60 a 64 años,3116466,1476667,1639799,2010
Estados Unidos Mexicanos,65 a 69 años,2317265,1095273,1221992,2010
Estados Unidos Mexicanos,70 a 74 años,1873934,873893,1000041,2010
Estados Unidos Mexicanos,75 a 79 años,1245483,579689,665794,2010
Estados Unidos Mexicanos,80 a 84 años,798936,355277,443659,2010
Estados Unidos Mexicanos,85 a 89 años,454164,197461,256703,2010
Estados Unidos Mexicanos,90 a 94 años,164924,68130,96794,2010
Estados Unidos Mexicanos,95 a 99 años,65732,25920,39812,2010
Estados Unidos Mexicanos,100 años y más,18475,7228,11247,2010
Estados Unidos Mexicanos,No especificado,1397406,700219,697187,2010
Aguascalientes,0 a 4 años,121557,61941,59616,2010
Aguascalientes,5 a 9 años,128874,65572,63302,2010
Aguascalientes,10 a 14 años,123806,62615,61191,2010
Aguascalientes,15 a 19 años,121428,60636,60792,2010
Aguascalientes,20 a 24 años,106305,51431,54874,2010
Aguascalientes,25 a 29 años,93604,44568,49036,2010
Aguascalientes,30 a 34 años,88726,41962,46764,2010
Aguascalientes,35 a 39 años,86254,40569,45685,2010
Aguascalientes,40 a 44 años,73084,34381,38703,2010
Aguascalientes,45 a 49 años,60198,28420,31778,2010
Aguascalientes,50 a 54 años,49980,23436,26544,2010
Aguascalientes,55 a 59 años,37543,17960,19583,2010
Aguascalientes,60 a 64 años,29258,13686,15572,2010
Aguascalientes,65 a 69 años,21004,9895,11109,2010
Aguascalientes,70 a 74 años,15254,6967,8287,2010
Aguascalientes,75 a 79 años,10673,4862,5811,2010
Aguascalientes,80 a 84 años,7228,3094,4134,2010
Aguascalientes,85 a 89 años,4061,1780,2281,2010
Aguascalientes,90 a 94 años,1467,605,862,2010
Aguascalientes,95 a 99 años,551,229,322,2010
Aguascalientes,100 años y más,109,45,64,2010
Aguascalientes,No especificado,4032,1984,2048,2010
Baja California,0 a 4 años,293234,149167,144067,2010
Baja California,5 a 9 años,303180,153886,149294,2010
Baja California,10 a 14 años,305472,155483,149989,2010
Baja California,15 a 19 años,299195,152077,147118,2010
Baja California,20 a 24 años,286479,144597,141882,2010
Baja California,25 a 29 años,265428,133546,131882,2010
Baja California,30 a 34 años,264023,132857,131166,2010
Baja California,35 a 39 años,264063,135331,128732,2010
Baja California,40 a 44 años,215049,110722,104327,2010
Baja California,45 a 49 años,171104,86928,84176,2010
Baja California,50 a 54 años,136690,68093,68597,2010
Baja California,55 a 59 años,97874,48250,49624,2010
Baja California,60 a 64 años,75229,36151,39078,2010
Baja California,65 a 69 años,52560,25086,27474,2010
Baja California,70 a 74 años,37742,17956,19786,2010
Baja California,75 a 79 años,24055,11223,12832,2010
Baja California,80 a 84 años,14744,6578,8166,2010
Baja California,85 a 89 años,7764,3360,4404,2010
Baja California,90 a 94 años,2641,1079,1562,2010
Baja California,95 a 99 años,913,314,599,2010
Baja California,100 años y más,206,57,149,2010
Baja California,No especificado,37425,18869,18556,2010
Baja California Sur,0 a 4 años,60758,30840,29918,2010
Baja California Sur,5 a 9 años,60334,30636,29698,2010
Baja California Sur,10 a 14 años,57380,29340,28040,2010
Baja California Sur,15 a 19 años,57713,29730,27983,2010
Baja California Sur,20 a 24 años,58690,30273,28417,2010
Baja California Sur,25 a 29 años,57525,29600,27925,2010
Baja California Sur,30 a 34 años,56159,28734,27425,2010
Baja California Sur,35 a 39 años,52235,26810,25425,2010
Baja California Sur,40 a 44 años,42163,21760,20403,2010
Baja California Sur,45 a 49 años,34308,17451,16857,2010
Baja California Sur,50 a 54 años,28122,14297,13825,2010
Baja California Sur,55 a 59 años,20188,10384,9804,2010
Baja California Sur,60 a 64 años,14895,7573,7322,2010
Baja California Sur,65 a 69 años,10279,5225,5054,2010
Baja California Sur,70 a 74 años,7012,3480,3532,2010
Baja California Sur,75 a 79 años,4598,2283,2315,2010
Baja California Sur,80 a 84 años,2805,1284,1521,2010
Baja California Sur,85 a 89 años,1589,677,912,2010
Baja California Sur,90 a 94 años,655,265,390,2010
Baja California Sur,95 a 99 años,223,82,141,2010
Baja California Sur,100 años y más,58,27,31,2010
Baja California Sur,No especificado,9337,4682,4655,2010
Campeche,0 a 4 años,76925,39317,37608,2010
Campeche,5 a 9 años,78299,39758,38541,2010
Campeche,10 a 14 años,81314,41146,40168,2010
Campeche,15 a 19 años,82920,41693,41227,2010
Campeche,20 a 24 años,76388,37219,39169,2010
Campeche,25 a 29 años,68197,32562,35635,2010
Campeche,30 a 34 años,64927,30991,33936,2010
Campeche,35 a 39 años,61896,30049,31847,2010
Campeche,40 a 44 años,50522,24853,25669,2010
Campeche,45 a 49 años,42811,21000,21811,2010
Campeche,50 a 54 años,35658,17658,18000,2010
Campeche,55 a 59 años,28316,14154,14162,2010
Campeche,60 a 64 años,21379,10611,10768,2010
Campeche,65 a 69 años,15079,7595,7484,2010
Campeche,70 a 74 años,12890,6468,6422,2010
Campeche,75 a 79 años,8320,4276,4044,2010
Campeche,80 a 84 años,5254,2687,2567,2010
Campeche,85 a 89 años,3209,1620,1589,2010
Campeche,90 a 94 años,1127,573,554,2010
Campeche,95 a 99 años,479,223,256,2010
Campeche,100 años y más,142,75,67,2010
Campeche,No especificado,6389,3193,3196,2010
Coahuila de Zaragoza,0 a 4 años,258246,131289,126957,2010
Coahuila de Zaragoza,5 a 9 años,270736,137858,132878,2010
Coahuila de Zaragoza,10 a 14 años,268193,136153,132040,2010
Coahuila de Zaragoza,15 a 19 años,261942,132477,129465,2010
Coahuila de Zaragoza,20 a 24 años,230132,115443,114689,2010
Coahuila de Zaragoza,25 a 29 años,210236,104230,106006,2010
Coahuila de Zaragoza,30 a 34 años,216325,106088,110237,2010
Coahuila de Zaragoza,35 a 39 años,211770,103371,108399,2010
Coahuila de Zaragoza,40 a 44 años,177554,86374,91180,2010
Coahuila de Zaragoza,45 a 49 años,150271,72906,77365,2010
Coahuila de Zaragoza,50 a 54 años,125961,60909,65052,2010
Coahuila de Zaragoza,55 a 59 años,95121,46924,48197,2010
Coahuila de Zaragoza,60 a 64 años,77527,37467,40060,2010
Coahuila de Zaragoza,65 a 69 años,55667,26827,28840,2010
Coahuila de Zaragoza,70 a 74 años,42832,20407,22425,2010
Coahuila de Zaragoza,75 a 79 años,27610,13197,14413,2010
Coahuila de Zaragoza,80 a 84 años,17076,7645,9431,2010
Coahuila de Zaragoza,85 a 89 años,9002,3900,5102,2010
Coahuila de Zaragoza,90 a 94 años,2959,1238,1721,2010
Coahuila de Zaragoza,95 a 99 años,1008,385,623,2010
Coahuila de Zaragoza,100 años y más,263,91,172,2010
Coahuila de Zaragoza,No especificado,37960,19018,18942,2010
Colima,0 a 4 años,58263,29676,28587,2010
Colima,5 a 9 años,59869,30334,29535,2010
Colima,10 a 14 años,59473,30707,28766,2010
Colima,15 a 19 años,62323,31543,30780,2010
Colima,20 a 24 años,60070,29487,30583,2010
Colima,25 a 29 años,53136,25994,27142,2010
Colima,30 a 34 años,50521,24590,25931,2010
Colima,35 a 39 años,48863,23868,24995,2010
Colima,40 a 44 años,41432,20101,21331,2010
Colima,45 a 49 años,35812,17505,18307,2010
Colima,50 a 54 años,30917,15247,15670,2010
Colima,55 a 59 años,23301,11581,11720,2010
Colima,60 a 64 años,18355,8939,9416,2010
Colima,65 a 69 años,13806,6765,7041,2010
Colima,70 a 74 años,10239,4918,5321,2010
Colima,75 a 79 años,6976,3375,3601,2010
Colima,80 a 84 años,4565,2050,2515,2010
Colima,85 a 89 años,2906,1352,1554,2010
Colima,90 a 94 años,1259,531,728,2010
Colima,95 a 99 años,499,228,271,2010
Colima,100 años y más,123,65,58,2010
Colima,No especificado,7847,3934,3913,2010
Chiapas,0 a 4 años,540459,273660,266799,2010
Chiapas,5 a 9 años,554692,280057,274635,2010
Chiapas,10 a 14 años,549896,279274,270622,2010
Chiapas,15 a 19 años,530233,262407,267826,2010
Chiapas,20 a 24 años,438019,207582,230437,2010
Chiapas,25 a 29 años,366537,170660,195877,2010
Chiapas,30 a 34 años,335370,157234,178136,2010
Chiapas,35 a 39 años,307983,145306,162677,2010
Chiapas,40 a 44 años,246620,119049,127571,2010
Chiapas,45 a 49 años,212924,103387,109537,2010
Chiapas,50 a 54 años,174407,85517,88890,2010
Chiapas,55 a 59 años,137559,69026,68533,2010
Chiapas,60 a 64 años,110499,54902,55597,2010
Chiapas,65 a 69 años,78922,38302,40620,2010
Chiapas,70 a 74 años,68500,34470,34030,2010
Chiapas,75 a 79 años,39750,20238,19512,2010
Chiapas,80 a 84 años,24678,12299,12379,2010
Chiapas,85 a 89 años,13513,6572,6941,2010
Chiapas,90 a 94 años,5569,2754,2815,2010
Chiapas,95 a 99 años,2583,1226,1357,2010
Chiapas,100 años y más,1467,726,741,2010
Chiapas,No especificado,56400,28159,28241,2010
Chihuahua,0 a 4 años,322676,163607,159069,2010
Chihuahua,5 a 9 años,335064,170477,164587,2010
Chihuahua,10 a 14 años,324661,164749,159912,2010
Chihuahua,15 a 19 años,322034,162488,159546,2010
Chihuahua,20 a 24 años,285872,142953,142919,2010
Chihuahua,25 a 29 años,255036,126385,128651,2010
Chihuahua,30 a 34 años,251304,124137,127167,2010
Chihuahua,35 a 39 años,259968,128448,131520,2010
Chihuahua,40 a 44 años,222756,109944,112812,2010
Chihuahua,45 a 49 años,183153,89363,93790,2010
Chihuahua,50 a 54 años,149069,71988,77081,2010
Chihuahua,55 a 59 años,108607,52311,56296,2010
Chihuahua,60 a 64 años,89542,42534,47008,2010
Chihuahua,65 a 69 años,68809,32811,35998,2010
Chihuahua,70 a 74 años,54419,26273,28146,2010
Chihuahua,75 a 79 años,34386,16544,17842,2010
Chihuahua,80 a 84 años,20704,9435,11269,2010
Chihuahua,85 a 89 años,10184,4404,5780,2010
Chihuahua,90 a 94 años,3294,1383,1911,2010
Chihuahua,95 a 99 años,1101,428,673,2010
Chihuahua,100 años y más,286,113,173,2010
Chihuahua,No especificado,103540,51770,51770,2010
Ciudad de México,0 a 4 años,618245,314701,303544,2010
Ciudad de México,5 a 9 años,658948,334885,324063,2010
Ciudad de México,10 a 14 años,660345,334674,325671,2010
Ciudad de México,15 a 19 años,723372,363265,360107,2010
Ciudad de México,20 a 24 años,753404,372368,381036,2010
Ciudad de México,25 a 29 años,726696,352969,373727,2010
Ciudad de México,30 a 34 años,702642,335988,366654,2010
Ciudad de México,35 a 39 años,722214,341865,380349,2010
Ciudad de México,40 a 44 años,629563,295151,334412,2010
Ciudad de México,45 a 49 años,555481,256078,299403,2010
Ciudad de México,50 a 54 años,506310,230325,275985,2010
Ciudad de México,55 a 59 años,392186,179065,213121,2010
Ciudad de México,60 a 64 años,315793,141010,174783,2010
Ciudad de México,65 a 69 años,227625,99910,127715,2010
Ciudad de México,70 a 74 años,179329,75227,104102,2010
Ciudad de México,75 a 79 años,124499,50795,73704,2010
Ciudad de México,80 a 84 años,85121,32012,53109,2010
Ciudad de México,85 a 89 años,47170,17062,30108,2010
Ciudad de México,90 a 94 años,17225,5529,11696,2010
Ciudad de México,95 a 99 años,5797,1688,4109,2010
Ciudad de México,100 años y más,1089,321,768,2010
Ciudad de México,No especificado,198026,98895,99131,2010
Durango,0 a 4 años,161700,82046,79654,2010
Durango,5 a 9 años,166853,84823,82030,2010
Durango,10 a 14 años,167180,84969,82211,2010
Durango,15 a 19 años,166366,84036,82330,2010
Durango,20 a 24 años,143377,70380,72997,2010
Durango,25 a 29 años,117714,56978,60736,2010
Durango,30 a 34 años,115294,55171,60123,2010
Durango,35 a 39 años,112837,54244,58593,2010
Durango,40 a 44 años,96859,46107,50752,2010
Durango,45 a 49 años,82516,38967,43549,2010
Durango,50 a 54 años,70274,33322,36952,2010
Durango,55 a 59 años,53875,26022,27853,2010
Durango,60 a 64 años,44693,21418,23275,2010
Durango,65 a 69 años,34601,16948,17653,2010
Durango,70 a 74 años,29733,14618,15115,2010
Durango,75 a 79 años,19595,9739,9856,2010
Durango,80 a 84 años,12039,5751,6288,2010
Durango,85 a 89 años,6079,2885,3194,2010
Durango,90 a 94 años,1953,843,1110,2010
Durango,95 a 99 años,753,336,417,2010
Durango,100 años y más,235,84,151,2010
Durango,No especificado,28408,14203,14205,2010
Guanajuato,0 a 4 años,547466,277260,270206,2010
Guanajuato,5 a 9 años,579121,293697,285424,2010
Guanajuato,10 a 14 años,580600,293612,286988,2010
Guanajuato,15 a 19 años,570965,281501,289464,2010
Guanajuato,20 a 24 años,493167,230992,262175,2010
Guanajuato,25 a 29 años,425291,196248,229043,2010
Guanajuato,30 a 34 años,407712,187888,219824,2010
Guanajuato,35 a 39 años,387687,181162,206525,2010
Guanajuato,40 a 44 años,324654,150828,173826,2010
Guanajuato,45 a 49 años,266465,123887,142578,2010
Guanajuato,50 a 54 años,225760,105052,120708,2010
Guanajuato,55 a 59 años,174400,82431,91969,2010
Guanajuato,60 a 64 años,140229,65751,74478,2010
Guanajuato,65 a 69 años,105229,49694,55535,2010
Guanajuato,70 a 74 años,86650,40438,46212,2010
Guanajuato,75 a 79 años,60341,28292,32049,2010
Guanajuato,80 a 84 años,42362,19159,23203,2010
Guanajuato,85 a 89 años,24163,10738,13425,2010
Guanajuato,90 a 94 años,8603,3616,4987,2010
Guanajuato,95 a 99 años,3588,1403,2185,2010
Guanajuato,100 años y más,766,276,490,2010
Guanajuato,No especificado,31153,15500,15653,2010
Guerrero,0 a 4 años,353009,179246,173763,2010
Guerrero,5 a 9 años,378197,191053,187144,2010
Guerrero,10 a 14 años,393378,198888,194490,2010
Guerrero,15 a 19 años,372191,184645,187546,2010
Guerrero,20 a 24 años,290684,137993,152691,2010
Guerrero,25 a 29 años,237815,111428,126387,2010
Guerrero,30 a 34 años,223482,104473,119009,2010
Guerrero,35 a 39 años,211923,99320,112603,2010
Guerrero,40 a 44 años,178482,83944,94538,2010
Guerrero,45 a 49 años,158413,73976,84437,2010
Guerrero,50 a 54 años,137260,64884,72376,2010
Guerrero,55 a 59 años,110858,53232,57626,2010
Guerrero,60 a 64 años,89041,42136,46905,2010
Guerrero,65 a 69 años,72733,33837,38896,2010
Guerrero,70 a 74 años,66668,31228,35440,2010
Guerrero,75 a 79 años,43749,20709,23040,2010
Guerrero,80 a 84 años,26491,12278,14213,2010
Guerrero,85 a 89 años,14892,6809,8083,2010
Guerrero,90 a 94 años,5898,2667,3231,2010
Guerrero,95 a 99 años,2810,1244,1566,2010
Guerrero,100 años y más,1186,505,681,2010
Guerrero,No especificado,19608,11066,8542,2010
Hidalgo,0 a 4 años,255202,129514,125688,2010
Hidalgo,5 a 9 años,271181,137456,133725,2010
Hidalgo,10 a 14 años,263026,133304,129722,2010
Hidalgo,15 a 19 años,269602,134493,135109,2010
Hidalgo,20 a 24 años,226170,106172,119998,2010
Hidalgo,25 a 29 años,201034,91783,109251,2010
Hidalgo,30 a 34 años,197047,90262,106785,2010
Hidalgo,35 a 39 años,191131,88478,102653,2010
Hidalgo,40 a 44 años,162857,76199,86658,2010
Hidalgo,45 a 49 años,140325,65837,74488,2010
Hidalgo,50 a 54 años,120304,57248,63056,2010
Hidalgo,55 a 59 años,95265,46282,48983,2010
Hidalgo,60 a 64 años,74476,35915,38561,2010
Hidalgo,65 a 69 años,57669,27765,29904,2010
Hidalgo,70 a 74 años,48068,22456,25612,2010
Hidalgo,75 a 79 años,31279,14642,16637,2010
Hidalgo,80 a 84 años,19997,8912,11085,2010
Hidalgo,85 a 89 años,12043,5139,6904,2010
Hidalgo,90 a 94 años,4577,1862,2715,2010
Hidalgo,95 a 99 años,1952,716,1236,2010
Hidalgo,100 años y más,654,235,419,2010
Hidalgo,No especificado,21159,10552,10607,2010
Jalisco,0 a 4 años,694948,353751,341197,2010
Jalisco,5 a 9 años,727075,369308,357767,2010
Jalisco,10 a 14 años,714393,362097,352296,2010
Jalisco,15 a 19 años,715003,360175,354828,2010
Jalisco,20 a 24 años,669088,329145,339943,2010
Jalisco,25 a 29 años,592033,287723,304310,2010
Jalisco,30 a 34 años,548117,263140,284977,2010
Jalisco,35 a 39 años,535234,258270,276964,2010
Jalisco,40 a 44 años,446601,213669,232932,2010
Jalisco,45 a 49 años,371541,175474,196067,2010
Jalisco,50 a 54 años,324277,152109,172168,2010
Jalisco,55 a 59 años,254380,120383,133997,2010
Jalisco,60 a 64 años,210465,99337,111128,2010
Jalisco,65 a 69 años,155337,73976,81361,2010
Jalisco,70 a 74 años,118204,55172,63032,2010
Jalisco,75 a 79 años,80747,37383,43364,2010
Jalisco,80 a 84 años,53964,23768,30196,2010
Jalisco,85 a 89 años,32720,14255,18465,2010
Jalisco,90 a 94 años,13596,5628,7968,2010
Jalisco,95 a 99 años,5206,2133,3073,2010
Jalisco,100 años y más,1084,415,669,2010
Jalisco,No especificado,86669,43330,43339,2010
México,0 a 4 años,1426612,723127,703485,2010
México,5 a 9 años,1498274,760231,738043,2010
México,10 a 14 años,1429028,723622,705406,2010
México,15 a 19 años,1467148,734320,732828,2010
México,20 a 24 años,1364380,668827,695553,2010
México,25 a 29 años,1233854,591831,642023,2010
México,30 a 34 años,1198515,565928,632587,2010
México,35 a 39 años,1193988,566526,627462,2010
México,40 a 44 años,1003492,478370,525122,2010
México,45 a 49 años,831164,395154,436010,2010
México,50 a 54 años,695328,329825,365503,2010
México,55 a 59 años,509884,244538,265346,2010
México,60 a 64 años,392349,185672,206677,2010
México,65 a 69 años,270138,126755,143383,2010
México,70 a 74 años,200542,91438,109104,2010
México,75 a 79 años,129423,58326,71097,2010
México,80 a 84 años,78893,33293,45600,2010
México,85 a 89 años,44498,17985,26513,2010
México,90 a 94 años,14612,5459,9153,2010
México,95 a 99 años,5814,1925,3889,2010
México,100 años y más,1378,424,954,2010
México,No especificado,186548,93410,93138,2010
Michoacán de Ocampo,0 a 4 años,425698,215617,210081,2010
Michoacán de Ocampo,5 a 9 años,434860,220017,214843,2010
Michoacán de Ocampo,10 a 14 años,443721,223553,220168,2010
Michoacán de Ocampo,15 a 19 años,453827,224452,229375,2010
Michoacán de Ocampo,20 a 24 años,392338,185190,207148,2010
Michoacán de Ocampo,25 a 29 años,322064,150160,171904,2010
Michoacán de Ocampo,30 a 34 años,303108,141058,162050,2010
Michoacán de Ocampo,35 a 39 años,290448,136834,153614,2010
Michoacán de Ocampo,40 a 44 años,247704,115521,132183,2010
Michoacán de Ocampo,45 a 49 años,212627,99106,113521,2010
Michoacán de Ocampo,50 a 54 años,188305,88214,100091,2010
Michoacán de Ocampo,55 a 59 años,147873,71049,76824,2010
Michoacán de Ocampo,60 a 64 años,122951,58031,64920,2010
Michoacán de Ocampo,65 a 69 años,96347,45789,50558,2010
Michoacán de Ocampo,70 a 74 años,83990,39343,44647,2010
Michoacán de Ocampo,75 a 79 años,58813,28096,30717,2010
Michoacán de Ocampo,80 a 84 años,40032,18583,21449,2010
Michoacán de Ocampo,85 a 89 años,23160,10696,12464,2010
Michoacán de Ocampo,90 a 94 años,8949,4017,4932,2010
Michoacán de Ocampo,95 a 99 años,3839,1652,2187,2010
Michoacán de Ocampo,100 años y más,1046,451,595,2010
Michoacán de Ocampo,No especificado,49337,24680,24657,2010
Morelos,0 a 4 años,155669,79434,76235,2010
Morelos,5 a 9 años,166908,85100,81808,2010
Morelos,10 a 14 años,167487,84822,82665,2010
Morelos,15 a 19 años,175625,87725,87900,2010
Morelos,20 a 24 años,155671,75194,80477,2010
Morelos,25 a 29 años,133544,62528,71016,2010
Morelos,30 a 34 años,128812,59712,69100,2010
Morelos,35 a 39 años,129072,59870,69202,2010
Morelos,40 a 44 años,111381,51504,59877,2010
Morelos,45 a 49 años,97105,45411,51694,2010
Morelos,50 a 54 años,86282,40293,45989,2010
Morelos,55 a 59 años,66904,31856,35048,2010
Morelos,60 a 64 años,53604,25556,28048,2010
Morelos,65 a 69 años,40104,18850,21254,2010
Morelos,70 a 74 años,32988,15169,17819,2010
Morelos,75 a 79 años,23535,10876,12659,2010
Morelos,80 a 84 años,14917,6621,8296,2010
Morelos,85 a 89 años,8567,3862,4705,2010
Morelos,90 a 94 años,2702,1147,1555,2010
Morelos,95 a 99 años,1134,464,670,2010
Morelos,100 años y más,327,136,191,2010
Morelos,No especificado,24889,12458,12431,2010
Nayarit,0 a 4 años,106044,54138,51906,2010
Nayarit,5 a 9 años,104943,53253,51690,2010
Nayarit,10 a 14 años,104308,53367,50941,2010
Nayarit,15 a 19 años,107191,54204,52987,2010
Nayarit,20 a 24 años,96693,48059,48634,2010
Nayarit,25 a 29 años,82067,40065,42002,2010
Nayarit,30 a 34 años,79520,38922,40598,2010
Nayarit,35 a 39 años,78128,38953,39175,2010
Nayarit,40 a 44 años,64675,31810,32865,2010
Nayarit,45 a 49 años,55916,27147,28769,2010
Nayarit,50 a 54 años,48769,23609,25160,2010
Nayarit,55 a 59 años,39899,19693,20206,2010
Nayarit,60 a 64 años,32069,15866,16203,2010
Nayarit,65 a 69 años,25368,12694,12674,2010
Nayarit,70 a 74 años,21066,10519,10547,2010
Nayarit,75 a 79 años,13928,7002,6926,2010
Nayarit,80 a 84 años,8690,4150,4540,2010
Nayarit,85 a 89 años,5111,2390,2721,2010
Nayarit,90 a 94 años,2113,944,1169,2010
Nayarit,95 a 99 años,799,368,431,2010
Nayarit,100 años y más,247,134,113,2010
Nayarit,No especificado,7435,3720,3715,2010
Nuevo León,0 a 4 años,413360,210075,203285,2010
Nuevo León,5 a 9 años,430525,219102,211423,2010
Nuevo León,10 a 14 años,415368,211365,204003,2010
Nuevo León,15 a 19 años,406428,205518,200910,2010
Nuevo León,20 a 24 años,401723,202766,198957,2010
Nuevo León,25 a 29 años,384086,192963,191123,2010
Nuevo León,30 a 34 años,383736,191204,192532,2010
Nuevo León,35 a 39 años,383357,191768,191589,2010
Nuevo León,40 a 44 años,321008,159078,161930,2010
Nuevo León,45 a 49 años,260606,128429,132177,2010
Nuevo León,50 a 54 años,220801,107080,113721,2010
Nuevo León,55 a 59 años,162140,78944,83196,2010
Nuevo León,60 a 64 años,132607,63516,69091,2010
Nuevo León,65 a 69 años,96803,46293,50510,2010
Nuevo León,70 a 74 años,75631,35695,39936,2010
Nuevo León,75 a 79 años,48049,22136,25913,2010
Nuevo León,80 a 84 años,30455,13075,17380,2010
Nuevo León,85 a 89 años,16005,6629,9376,2010
Nuevo León,90 a 94 años,5394,2066,3328,2010
Nuevo León,95 a 99 años,1874,695,1179,2010
Nuevo León,100 años y más,460,172,288,2010
Nuevo León,No especificado,63042,31616,31426,2010
Oaxaca,0 a 4 años,373371,189157,184214,2010
Oaxaca,5 a 9 años,399632,201833,197799,2010
Oaxaca,10 a 14 años,414392,209447,204945,2010
Oaxaca,15 a 19 años,406873,200381,206492,2010
Oaxaca,20 a 24 años,313523,145055,168468,2010
Oaxaca,25 a 29 años,268969,122545,146424,2010
Oaxaca,30 a 34 años,259112,117774,141338,2010
Oaxaca,35 a 39 años,244019,112008,132011,2010
Oaxaca,40 a 44 años,208666,96524,112142,2010
Oaxaca,45 a 49 años,187021,86487,100534,2010
Oaxaca,50 a 54 años,163536,75664,87872,2010
Oaxaca,55 a 59 años,134078,63189,70889,2010
Oaxaca,60 a 64 años,110092,51536,58556,2010
Oaxaca,65 a 69 años,90363,41593,48770,2010
Oaxaca,70 a 74 años,80884,37246,43638,2010
Oaxaca,75 a 79 años,55599,26055,29544,2010
Oaxaca,80 a 84 años,35768,16415,19353,2010
Oaxaca,85 a 89 años,21170,9631,11539,2010
Oaxaca,90 a 94 años,7840,3481,4359,2010
Oaxaca,95 a 99 años,3406,1401,2005,2010
Oaxaca,100 años y más,1047,407,640,2010
Oaxaca,No especificado,22601,11179,11422,2010
Puebla,0 a 4 años,574513,291584,282929,2010
Puebla,5 a 9 años,620386,314122,306264,2010
Puebla,10 a 14 años,604845,305657,299188,2010
Puebla,15 a 19 años,604094,299098,304996,2010
Puebla,20 a 24 años,511685,241187,270498,2010
Puebla,25 a 29 años,441558,203626,237932,2010
Puebla,30 a 34 años,420492,192949,227543,2010
Puebla,35 a 39 años,394961,182690,212271,2010
Puebla,40 a 44 años,328556,151228,177328,2010
Puebla,45 a 49 años,279425,129308,150117,2010
Puebla,50 a 54 años,240020,110377,129643,2010
Puebla,55 a 59 años,188919,88207,100712,2010
Puebla,60 a 64 años,150565,69041,81524,2010
Puebla,65 a 69 años,115990,53384,62606,2010
Puebla,70 a 74 años,96685,43408,53277,2010
Puebla,75 a 79 años,67019,30238,36781,2010
Puebla,80 a 84 años,43367,18969,24398,2010
Puebla,85 a 89 años,26380,11168,15212,2010
Puebla,90 a 94 años,9528,3906,5622,2010
Puebla,95 a 99 años,3845,1413,2432,2010
Puebla,100 años y más,1057,329,728,2010
Puebla,No especificado,55939,27966,27973,2010
Querétaro,0 a 4 años,178916,90972,87944,2010
Querétaro,5 a 9 años,183541,93230,90311,2010
Querétaro,10 a 14 años,182608,92453,90155,2010
Querétaro,15 a 19 años,187241,92904,94337,2010
Querétaro,20 a 24 años,168520,80717,87803,2010
Querétaro,25 a 29 años,153300,72317,80983,2010
Querétaro,30 a 34 años,145169,68081,77088,2010
Querétaro,35 a 39 años,138438,65728,72710,2010
Querétaro,40 a 44 años,114275,53763,60512,2010
Querétaro,45 a 49 años,93449,44472,48977,2010
Querétaro,50 a 54 años,76870,36628,40242,2010
Querétaro,55 a 59 años,56288,26912,29376,2010
Querétaro,60 a 64 años,42991,20110,22881,2010
Querétaro,65 a 69 años,31562,14757,16805,2010
Querétaro,70 a 74 años,24701,11421,13280,2010
Querétaro,75 a 79 años,16494,7562,8932,2010
Querétaro,80 a 84 años,10760,4641,6119,2010
Querétaro,85 a 89 años,6400,2751,3649,2010
Querétaro,90 a 94 años,2344,914,1430,2010
Querétaro,95 a 99 años,922,303,619,2010
Querétaro,100 años y más,207,70,137,2010
Querétaro,No especificado,12941,6482,6459,2010
Quintana Roo,0 a 4 años,133228,67703,65525,2010
Quintana Roo,5 a 9 años,126996,64151,62845,2010
Quintana Roo,10 a 14 años,121308,61790,59518,2010
Quintana Roo,15 a 19 años,128650,65411,63239,2010
Quintana Roo,20 a 24 años,135549,68519,67030,2010
Quintana Roo,25 a 29 años,130616,65694,64922,2010
Quintana Roo,30 a 34 años,120654,60588,60066,2010
Quintana Roo,35 a 39 años,111169,56596,54573,2010
Quintana Roo,40 a 44 años,86941,44886,42055,2010
Quintana Roo,45 a 49 años,64630,33236,31394,2010
Quintana Roo,50 a 54 años,48629,24865,23764,2010
Quintana Roo,55 a 59 años,34052,17591,16461,2010
Quintana Roo,60 a 64 años,24478,12373,12105,2010
Quintana Roo,65 a 69 años,15430,7924,7506,2010
Quintana Roo,70 a 74 años,10761,5469,5292,2010
Quintana Roo,75 a 79 años,6453,3276,3177,2010
Quintana Roo,80 a 84 años,3639,1831,1808,2010
Quintana Roo,85 a 89 años,2070,1048,1022,2010
Quintana Roo,90 a 94 años,761,387,374,2010
Quintana Roo,95 a 99 años,297,152,145,2010
Quintana Roo,100 años y más,76,43,33,2010
Quintana Roo,No especificado,19191,9687,9504,2010
San Luis Potosí,0 a 4 años,247057,125473,121584,2010
San Luis Potosí,5 a 9 años,268914,136027,132887,2010
San Luis Potosí,10 a 14 años,270154,136835,133319,2010
San Luis Potosí,15 a 19 años,269673,135204,134469,2010
San Luis Potosí,20 a 24 años,219720,105606,114114,2010
San Luis Potosí,25 a 29 años,189105,88319,100786,2010
San Luis Potosí,30 a 34 años,180250,84440,95810,2010
San Luis Potosí,35 a 39 años,175642,82850,92792,2010
San Luis Potosí,40 a 44 años,152372,71817,80555,2010
San Luis Potosí,45 a 49 años,131221,61913,69308,2010
San Luis Potosí,50 a 54 años,112519,53592,58927,2010
San Luis Potosí,55 a 59 años,87476,42563,44913,2010
San Luis Potosí,60 a 64 años,72960,34958,38002,2010
San Luis Potosí,65 a 69 años,56671,27526,29145,2010
San Luis Potosí,70 a 74 años,50213,24200,26013,2010
San Luis Potosí,75 a 79 años,34695,16937,17758,2010
San Luis Potosí,80 a 84 años,23325,11118,12207,2010
San Luis Potosí,85 a 89 años,13437,6316,7121,2010
San Luis Potosí,90 a 94 años,4303,1915,2388,2010
San Luis Potosí,95 a 99 años,1824,787,1037,2010
San Luis Potosí,100 años y más,548,205,343,2010
San Luis Potosí,No especificado,23439,11765,11674,2010
Sinaloa,0 a 4 años,252443,128664,123779,2010
Sinaloa,5 a 9 años,264538,134710,129828,2010
Sinaloa,10 a 14 años,270555,137580,132975,2010
Sinaloa,15 a 19 años,275540,139206,136334,2010
Sinaloa,20 a 24 años,242907,121634,121273,2010
Sinaloa,25 a 29 años,207840,102082,105758,2010
Sinaloa,30 a 34 años,207002,101645,105357,2010
Sinaloa,35 a 39 años,207622,102184,105438,2010
Sinaloa,40 a 44 años,176453,86505,89948,2010
Sinaloa,45 a 49 años,149915,72394,77521,2010
Sinaloa,50 a 54 años,131472,63091,68381,2010
Sinaloa,55 a 59 años,103936,51030,52906,2010
Sinaloa,60 a 64 años,83594,41082,42512,2010
Sinaloa,65 a 69 años,64032,31842,32190,2010
Sinaloa,70 a 74 años,51023,25289,25734,2010
Sinaloa,75 a 79 años,31659,15461,16198,2010
Sinaloa,80 a 84 años,19463,9028,10435,2010
Sinaloa,85 a 89 años,10809,4777,6032,2010
Sinaloa,90 a 94 años,4102,1720,2382,2010
Sinaloa,95 a 99 años,1625,665,960,2010
Sinaloa,100 años y más,418,176,242,2010
Sinaloa,No especificado,10813,5436,5377,2010
Sonora,0 a 4 años,250969,127915,123054,2010
Sonora,5 a 9 años,259950,132598,127352,2010
Sonora,10 a 14 años,256883,131336,125547,2010
Sonora,15 a 19 años,251510,128406,123104,2010
Sonora,20 a 24 años,228147,116320,111827,2010
Sonora,25 a 29 años,207251,104540,102711,2010
Sonora,30 a 34 años,205910,103146,102764,2010
Sonora,35 a 39 años,202731,102169,100562,2010
Sonora,40 a 44 años,172253,85722,86531,2010
Sonora,45 a 49 años,147842,73258,74584,2010
Sonora,50 a 54 años,128595,63397,65198,2010
Sonora,55 a 59 años,97274,48466,48808,2010
Sonora,60 a 64 años,74443,36506,37937,2010
Sonora,65 a 69 años,56240,27424,28816,2010
Sonora,70 a 74 años,43912,21279,22633,2010
Sonora,75 a 79 años,28060,13585,14475,2010
Sonora,80 a 84 años,17019,7746,9273,2010
Sonora,85 a 89 años,8961,3937,5024,2010
Sonora,90 a 94 años,3075,1247,1828,2010
Sonora,95 a 99 años,940,364,576,2010
Sonora,100 años y más,224,87,137,2010
Sonora,No especificado,20291,10164,10127,2010
Tabasco,0 a 4 años,223692,114194,109498,2010
Tabasco,5 a 9 años,225061,114145,110916,2010
Tabasco,10 a 14 años,220776,111804,108972,2010
Tabasco,15 a 19 años,224257,111911,112346,2010
Tabasco,20 a 24 años,206842,100048,106794,2010
Tabasco,25 a 29 años,185871,87169,98702,2010
Tabasco,30 a 34 años,174392,81829,92563,2010
Tabasco,35 a 39 años,164922,78148,86774,2010
Tabasco,40 a 44 años,136000,66024,69976,2010
Tabasco,45 a 49 años,116426,57375,59051,2010
Tabasco,50 a 54 años,95109,46912,48197,2010
Tabasco,55 a 59 años,72350,35982,36368,2010
Tabasco,60 a 64 años,51726,25607,26119,2010
Tabasco,65 a 69 años,38728,18954,19774,2010
Tabasco,70 a 74 años,32532,15959,16573,2010
Tabasco,75 a 79 años,21048,10617,10431,2010
Tabasco,80 a 84 años,12257,6092,6165,2010
Tabasco,85 a 89 años,7134,3374,3760,2010
Tabasco,90 a 94 años,2669,1275,1394,2010
Tabasco,95 a 99 años,1297,589,708,2010
Tabasco,100 años y más,536,235,301,2010
Tabasco,No especificado,24978,12515,12463,2010
Tamaulipas,0 a 4 años,302937,154457,148480,2010
Tamaulipas,5 a 9 años,305122,154618,150504,2010
Tamaulipas,10 a 14 años,294469,150104,144365,2010
Tamaulipas,15 a 19 años,291682,147251,144431,2010
Tamaulipas,20 a 24 años,275453,137058,138395,2010
Tamaulipas,25 a 29 años,258116,126215,131901,2010
Tamaulipas,30 a 34 años,255313,124108,131205,2010
Tamaulipas,35 a 39 años,250586,122278,128308,2010
Tamaulipas,40 a 44 años,213736,104304,109432,2010
Tamaulipas,45 a 49 años,177182,86829,90353,2010
Tamaulipas,50 a 54 años,147748,71602,76146,2010
Tamaulipas,55 a 59 años,109317,53327,55990,2010
Tamaulipas,60 a 64 años,89766,42359,47407,2010
Tamaulipas,65 a 69 años,66138,31179,34959,2010
Tamaulipas,70 a 74 años,53619,25167,28452,2010
Tamaulipas,75 a 79 años,35422,16664,18758,2010
Tamaulipas,80 a 84 años,22387,10054,12333,2010
Tamaulipas,85 a 89 años,12078,5302,6776,2010
Tamaulipas,90 a 94 años,3852,1589,2263,2010
Tamaulipas,95 a 99 años,1427,574,853,2010
Tamaulipas,100 años y más,408,169,239,2010
Tamaulipas,No especificado,101796,50993,50803,2010
Tlaxcala,0 a 4 años,116073,58980,57093,2010
Tlaxcala,5 a 9 años,123330,62673,60657,2010
Tlaxcala,10 a 14 años,118634,59970,58664,2010
Tlaxcala,15 a 19 años,119172,59831,59341,2010
Tlaxcala,20 a 24 años,104781,50406,54375,2010
Tlaxcala,25 a 29 años,93720,43235,50485,2010
Tlaxcala,30 a 34 años,90612,41672,48940,2010
Tlaxcala,35 a 39 años,84560,39297,45263,2010
Tlaxcala,40 a 44 años,71030,33139,37891,2010
Tlaxcala,45 a 49 años,58822,27512,31310,2010
Tlaxcala,50 a 54 años,49362,23079,26283,2010
Tlaxcala,55 a 59 años,36171,17210,18961,2010
Tlaxcala,60 a 64 años,28530,13597,14933,2010
Tlaxcala,65 a 69 años,21997,10353,11644,2010
Tlaxcala,70 a 74 años,17497,8197,9300,2010
Tlaxcala,75 a 79 años,13009,6108,6901,2010
Tlaxcala,80 a 84 años,8741,4056,4685,2010
Tlaxcala,85 a 89 años,5477,2493,2984,2010
Tlaxcala,90 a 94 años,1997,880,1117,2010
Tlaxcala,95 a 99 años,794,318,476,2010
Tlaxcala,100 años y más,187,75,112,2010
Tlaxcala,No especificado,5440,2694,2746,2010
Veracruz de Ignacio de la Llave,0 a 4 años,662288,335899,326389,2010
Veracruz de Ignacio de la Llave,5 a 9 años,728767,369775,358992,2010
Veracruz de Ignacio de la Llave,10 a 14 años,741526,376924,364602,2010
Veracruz de Ignacio de la Llave,15 a 19 años,759388,381351,378037,2010
Veracruz de Ignacio de la Llave,20 a 24 años,642093,307562,334531,2010
Veracruz de Ignacio de la Llave,25 a 29 años,557762,259153,298609,2010
Veracruz de Ignacio de la Llave,30 a 34 años,539685,247094,292591,2010
Veracruz de Ignacio de la Llave,35 a 39 años,542754,251277,291477,2010
Veracruz de Ignacio de la Llave,40 a 44 años,486810,228657,258153,2010
Veracruz de Ignacio de la Llave,45 a 49 años,424845,201515,223330,2010
Veracruz de Ignacio de la Llave,50 a 54 años,365591,172802,192789,2010
Veracruz de Ignacio de la Llave,55 a 59 años,298171,142619,155552,2010
Veracruz de Ignacio de la Llave,60 a 64 años,239698,114048,125650,2010
Veracruz de Ignacio de la Llave,65 a 69 años,183836,87365,96471,2010
Veracruz de Ignacio de la Llave,70 a 74 años,155346,72547,82799,2010
Veracruz de Ignacio de la Llave,75 a 79 años,100119,46658,53461,2010
Veracruz de Ignacio de la Llave,80 a 84 años,62627,28294,34333,2010
Veracruz de Ignacio de la Llave,85 a 89 años,35565,15779,19786,2010
Veracruz de Ignacio de la Llave,90 a 94 años,13213,5571,7642,2010
Veracruz de Ignacio de la Llave,95 a 99 años,5967,2503,3464,2010
Veracruz de Ignacio de la Llave,100 años y más,2186,890,1296,2010
Veracruz de Ignacio de la Llave,No especificado,94957,47396,47561,2010
Yucatán,0 a 4 años,170727,86219,84508,2010
Yucatán,5 a 9 años,181587,91892,89695,2010
Yucatán,10 a 14 años,182604,92921,89683,2010
Yucatán,15 a 19 años,192027,96613,95414,2010
Yucatán,20 a 24 años,183322,91013,92309,2010
Yucatán,25 a 29 años,160355,78443,81912,2010
Yucatán,30 a 34 años,151440,73129,78311,2010
Yucatán,35 a 39 años,145205,69998,75207,2010
Yucatán,40 a 44 años,116699,56265,60434,2010
Yucatán,45 a 49 años,101202,48528,52674,2010
Yucatán,50 a 54 años,87918,41814,46104,2010
Yucatán,55 a 59 años,73419,35354,38065,2010
Yucatán,60 a 64 años,61572,29647,31925,2010
Yucatán,65 a 69 años,44092,21271,22821,2010
Yucatán,70 a 74 años,35779,17334,18445,2010
Yucatán,75 a 79 años,24558,12071,12487,2010
Yucatán,80 a 84 años,15627,7491,8136,2010
Yucatán,85 a 89 años,9540,4618,4922,2010
Yucatán,90 a 94 años,3815,1743,2072,2010
Yucatán,95 a 99 años,1289,586,703,2010
Yucatán,100 años y más,202,88,114,2010
Yucatán,No especificado,12598,6295,6303,2010
Zacatecas,0 a 4 años,152037,77320,74717,2010
Zacatecas,5 a 9 años,151780,76898,74882,2010
Zacatecas,10 a 14 años,152154,77052,75102,2010
Zacatecas,15 a 19 años,150499,75169,75330,2010
Zacatecas,20 a 24 años,131079,62008,69071,2010
Zacatecas,25 a 29 años,107817,50416,57401,2010
Zacatecas,30 a 34 años,105427,49237,56190,2010
Zacatecas,35 a 39 años,101327,48473,52854,2010
Zacatecas,40 a 44 años,88979,42123,46856,2010
Zacatecas,45 a 49 años,74010,35111,38899,2010
Zacatecas,50 a 54 años,62448,29522,32926,2010
Zacatecas,55 a 59 años,47741,23002,24739,2010
Zacatecas,60 a 64 años,41090,19732,21358,2010
Zacatecas,65 a 69 años,34106,16684,17422,2010
Zacatecas,70 a 74 años,29225,14135,15090,2010
Zacatecas,75 a 79 años,21022,10463,10559,2010
Zacatecas,80 a 84 años,13941,6868,7073,2010
Zacatecas,85 a 89 años,8507,4152,4355,2010
Zacatecas,90 a 94 años,2832,1296,1536,2010
Zacatecas,95 a 99 años,1176,526,650,2010
Zacatecas,100 años y más,253,102,151,2010
Zacatecas,No especificado,13218,6608,6610,2010
Estados Unidos Mexicanos,0 a 4 años,10047365,5077482,4969883,2020
Estados Unidos Mexicanos,5 a 9 años,10764379,5453091,5311288,2020
Estados Unidos Mexicanos,10 a 14 años,10943540,5554260,5389280,2020
Estados Unidos Mexicanos,15 a 19 años,10806690,5462150,5344540,2020
Estados Unidos Mexicanos,20 a 24 años,10422095,5165884,5256211,2020
Estados Unidos Mexicanos,25 a 29 años,9993001,4861404,5131597,2020
Estados Unidos Mexicanos,30 a 34 años,9420827,4527726,4893101,2020
Estados Unidos Mexicanos,35 a 39 años,9020276,4331530,4688746,2020
Estados Unidos Mexicanos,40 a 44 años,8503586,4062304,4441282,2020
Estados Unidos Mexicanos,45 a 49 años,7942413,3812344,4130069,2020
Estados Unidos Mexicanos,50 a 54 años,7037532,3332163,3705369,2020
Estados Unidos Mexicanos,55 a 59 años,5695958,2692976,3002982,2020
Estados Unidos Mexicanos,60 a 64 años,4821062,2257862,2563200,2020
Estados Unidos Mexicanos,65 a 69 años,3645077,1706850,1938227,2020
Estados Unidos Mexicanos,70 a 74 años,2647340,1233492,1413848,2020
Estados Unidos Mexicanos,75 a 79 años,1814582,847898,966684,2020
Estados Unidos Mexicanos,80 a 84 años,1175364,523812,651552,2020
Estados Unidos Mexicanos,85 a 89 años,659245,283351,375894,2020
Estados Unidos Mexicanos,90 a 94 años,266806,107358,159448,2020
Estados Unidos Mexicanos,95 a 99 años,95205,36615,58590,2020
Estados Unidos Mexicanos,100 años y más,18295,6644,11651,2020
Estados Unidos Mexicanos,No especificado,273386,136194,137192,2020
Aguascalientes,0 a 4 años,124430,62978,61452,2020
Aguascalientes,5 a 9 años,131048,66359,64689,2020
Aguascalientes,10 a 14 años,129717,66080,63637,2020
Aguascalientes,15 a 19 años,131967,66903,65064,2020
Aguascalientes,20 a 24 años,127020,63154,63866,2020
Aguascalientes,25 a 29 años,118426,58141,60285,2020
Aguascalientes,30 a 34 años,106825,51651,55174,2020
Aguascalientes,35 a 39 años,99257,47774,51483,2020
Aguascalientes,40 a 44 años,92378,43839,48539,2020
Aguascalientes,45 a 49 años,84669,40163,44506,2020
Aguascalientes,50 a 54 años,74121,34611,39510,2020
Aguascalientes,55 a 59 años,58865,27608,31257,2020
Aguascalientes,60 a 64 años,48306,22435,25871,2020
Aguascalientes,65 a 69 años,35823,16698,19125,2020
Aguascalientes,70 a 74 años,25586,11782,13804,2020
Aguascalientes,75 a 79 años,16581,7739,8842,2020
Aguascalientes,80 a 84 años,10186,4397,5789,2020
Aguascalientes,85 a 89 años,5576,2360,3216,2020
Aguascalientes,90 a 94 años,2410,942,1468,2020
Aguascalientes,95 a 99 años,796,284,512,2020
Aguascalientes,100 años y más,112,36,76,2020
Aguascalientes,No especificado,1508,749,759,2020
Baja California,0 a 4 años,266301,134410,131891,2020
Baja California,5 a 9 años,299654,152609,147045,2020
Baja California,10 a 14 años,312348,159306,153042,2020
Baja California,15 a 19 años,315639,161298,154341,2020
Baja California,20 a 24 años,340359,173450,166909,2020
Baja California,25 a 29 años,328244,166250,161994,2020
Baja California,30 a 34 años,302389,152164,150225,2020
Baja California,35 a 39 años,292069,148169,143900,2020
Baja California,40 a 44 años,273611,138332,135279,2020
Baja California,45 a 49 años,260844,134187,126657,2020
Baja California,50 a 54 años,221388,112789,108599,2020
Baja California,55 a 59 años,168653,84778,83875,2020
Baja California,60 a 64 años,134022,65287,68735,2020
Baja California,65 a 69 años,94704,44982,49722,2020
Baja California,70 a 74 años,65425,30812,34613,2020
Baja California,75 a 79 años,40874,18833,22041,2020
Baja California,80 a 84 años,25204,11060,14144,2020
Baja California,85 a 89 años,12451,5277,7174,2020
Baja California,90 a 94 años,4858,1897,2961,2020
Baja California,95 a 99 años,1512,522,990,2020
Baja California,100 años y más,252,81,171,2020
Baja California,No especificado,8219,4096,4123,2020
Baja California Sur,0 a 4 años,62455,31479,30976,2020
Baja California Sur,5 a 9 años,66933,33962,32971,2020
Baja California Sur,10 a 14 años,67665,34455,33210,2020
Baja California Sur,15 a 19 años,65469,33788,31681,2020
Baja California Sur,20 a 24 años,66743,34418,32325,2020
Baja California Sur,25 a 29 años,68798,35046,33752,2020
Baja California Sur,30 a 34 años,67779,34653,33126,2020
Baja California Sur,35 a 39 años,64927,33289,31638,2020
Baja California Sur,40 a 44 años,59389,30390,28999,2020
Baja California Sur,45 a 49 años,51771,26718,25053,2020
Baja California Sur,50 a 54 años,43337,21910,21427,2020
Baja California Sur,55 a 59 años,33731,16905,16826,2020
Baja California Sur,60 a 64 años,27095,13415,13680,2020
Baja California Sur,65 a 69 años,19274,9587,9687,2020
Baja California Sur,70 a 74 años,12545,6165,6380,2020
Baja California Sur,75 a 79 años,8166,3984,4182,2020
Baja California Sur,80 a 84 años,4649,2134,2515,2020
Baja California Sur,85 a 89 años,2556,1165,1391,2020
Baja California Sur,90 a 94 años,936,367,569,2020
Baja California Sur,95 a 99 años,332,118,214,2020
Baja California Sur,100 años y más,55,18,37,2020
Baja California Sur,No especificado,3842,1913,1929,2020
Campeche,0 a 4 años,78935,39817,39118,2020
Campeche,5 a 9 años,82015,41624,40391,2020
Campeche,10 a 14 años,80168,41047,39121,2020
Campeche,15 a 19 años,76140,38468,37672,2020
Campeche,20 a 24 años,75556,37277,38279,2020
Campeche,25 a 29 años,72798,35046,37752,2020
Campeche,30 a 34 años,72709,34557,38152,2020
Campeche,35 a 39 años,70275,33611,36664,2020
Campeche,40 a 44 años,64170,30761,33409,2020
Campeche,45 a 49 años,57628,28036,29592,2020
Campeche,50 a 54 años,50254,24392,25862,2020
Campeche,55 a 59 años,40805,19857,20948,2020
Campeche,60 a 64 años,32778,16020,16758,2020
Campeche,65 a 69 años,25796,12530,13266,2020
Campeche,70 a 74 años,17559,8668,8891,2020
Campeche,75 a 79 años,11916,5984,5932,2020
Campeche,80 a 84 años,7536,3718,3818,2020
Campeche,85 a 89 años,4413,2113,2300,2020
Campeche,90 a 94 años,1768,832,936,2020
Campeche,95 a 99 años,701,353,348,2020
Campeche,100 años y más,149,78,71,2020
Campeche,No especificado,4294,2150,2144,2020
Coahuila de Zaragoza,0 a 4 años,279912,141812,138100,2020
Coahuila de Zaragoza,5 a 9 años,276224,140417,135807,2020
Coahuila de Zaragoza,10 a 14 años,268144,136301,131843,2020
Coahuila de Zaragoza,15 a 19 años,269284,136850,132434,2020
Coahuila de Zaragoza,20 a 24 años,264313,133659,130654,2020
Coahuila de Zaragoza,25 a 29 años,245917,122570,123347,2020
Coahuila de Zaragoza,30 a 34 años,224329,110882,113447,2020
Coahuila de Zaragoza,35 a 39 años,219634,109371,110263,2020
Coahuila de Zaragoza,40 a 44 años,218687,106991,111696,2020
Coahuila de Zaragoza,45 a 49 años,205202,100846,104356,2020
Coahuila de Zaragoza,50 a 54 años,178214,86423,91791,2020
Coahuila de Zaragoza,55 a 59 años,142215,69115,73100,2020
Coahuila de Zaragoza,60 a 64 años,118950,57307,61643,2020
Coahuila de Zaragoza,65 a 69 años,84422,40630,43792,2020
Coahuila de Zaragoza,70 a 74 años,61684,29458,32226,2020
Coahuila de Zaragoza,75 a 79 años,39801,18836,20965,2020
Coahuila de Zaragoza,80 a 84 años,24851,11199,13652,2020
Coahuila de Zaragoza,85 a 89 años,12495,5503,6992,2020
Coahuila de Zaragoza,90 a 94 años,4712,1826,2886,2020
Coahuila de Zaragoza,95 a 99 años,1408,529,879,2020
Coahuila de Zaragoza,100 años y más,214,70,144,2020
Coahuila de Zaragoza,No especificado,6159,3074,3085,2020
Colima,0 a 4 años,52313,26532,25781,2020
Colima,5 a 9 años,60049,30646,29403,2020
Colima,10 a 14 años,60801,30952,29849,2020
Colima,15 a 19 años,60663,30667,29996,2020
Colima,20 a 24 años,59343,29637,29706,2020
Colima,25 a 29 años,58035,28584,29451,2020
Colima,30 a 34 años,57436,27688,29748,2020
Colima,35 a 39 años,54566,26634,27932,2020
Colima,40 a 44 años,51179,24786,26393,2020
Colima,45 a 49 años,47133,23147,23986,2020
Colima,50 a 54 años,41541,20037,21504,2020
Colima,55 a 59 años,34819,16843,17976,2020
Colima,60 a 64 años,29795,14473,15322,2020
Colima,65 a 69 años,22071,10602,11469,2020
Colima,70 a 74 años,16086,7710,8376,2020
Colima,75 a 79 años,10803,5101,5702,2020
Colima,80 a 84 años,6859,3103,3756,2020
Colima,85 a 89 años,3623,1561,2062,2020
Colima,90 a 94 años,1571,655,916,2020
Colima,95 a 99 años,601,236,365,2020
Colima,100 años y más,148,53,95,2020
Colima,No especificado,1956,975,981,2020
Chiapas,0 a 4 años,574152,288911,285241,2020
Chiapas,5 a 9 años,612792,308758,304034,2020
Chiapas,10 a 14 años,583132,295114,288018,2020
Chiapas,15 a 19 años,526577,262521,264056,2020
Chiapas,20 a 24 años,464523,223732,240791,2020
Chiapas,25 a 29 años,424403,198455,225948,2020
Chiapas,30 a 34 años,396045,184761,211284,2020
Chiapas,35 a 39 años,372863,174270,198593,2020
Chiapas,40 a 44 años,329204,156472,172732,2020
Chiapas,45 a 49 años,284333,135809,148524,2020
Chiapas,50 a 54 años,243848,117157,126691,2020
Chiapas,55 a 59 años,196355,94905,101450,2020
Chiapas,60 a 64 años,158726,77668,81058,2020
Chiapas,65 a 69 años,125777,62035,63742,2020
Chiapas,70 a 74 años,85855,43119,42736,2020
Chiapas,75 a 79 años,63158,31971,31187,2020
Chiapas,80 a 84 años,38245,19047,19198,2020
Chiapas,85 a 89 años,21839,10638,11201,2020
Chiapas,90 a 94 años,8853,4300,4553,2020
Chiapas,95 a 99 años,3855,1752,2103,2020
Chiapas,100 años y más,1449,651,798,2020
Chiapas,No especificado,27844,13901,13943,2020
Chihuahua,0 a 4 años,291286,147610,143676,2020
Chihuahua,5 a 9 años,317322,161182,156140,2020
Chihuahua,10 a 14 años,333715,169615,164100,2020
Chihuahua,15 a 19 años,326333,165942,160391,2020
Chihuahua,20 a 24 años,314067,157281,156786,2020
Chihuahua,25 a 29 años,298299,147844,150455,2020
Chihuahua,30 a 34 años,275644,135649,139995,2020
Chihuahua,35 a 39 años,263669,130612,133057,2020
Chihuahua,40 a 44 años,251983,124354,127629,2020
Chihuahua,45 a 49 años,248522,123238,125284,2020
Chihuahua,50 a 54 años,219930,107604,112326,2020
Chihuahua,55 a 59 años,173639,84028,89611,2020
Chihuahua,60 a 64 años,140861,66530,74331,2020
Chihuahua,65 a 69 años,100944,47253,53691,2020
Chihuahua,70 a 74 años,74018,34187,39831,2020
Chihuahua,75 a 79 años,50265,23473,26792,2020
Chihuahua,80 a 84 años,31387,14273,17114,2020
Chihuahua,85 a 89 años,15250,6585,8665,2020
Chihuahua,90 a 94 años,5376,2130,3246,2020
Chihuahua,95 a 99 años,1477,531,946,2020
Chihuahua,100 años y más,243,88,155,2020
Chihuahua,No especificado,7639,3813,3826,2020
Ciudad de México,0 a 4 años,479904,242877,237027,2020
Ciudad de México,5 a 9 años,563907,286280,277627,2020
Ciudad de México,10 a 14 años,608962,309140,299822,2020
Ciudad de México,15 a 19 años,650389,331109,319280,2020
Ciudad de México,20 a 24 años,714605,359049,355556,2020
Ciudad de México,25 a 29 años,752289,372081,380208,2020
Ciudad de México,30 a 34 años,743611,363448,380163,2020
Ciudad de México,35 a 39 años,705850,340545,365305,2020
Ciudad de México,40 a 44 años,670307,317312,352995,2020
Ciudad de México,45 a 49 años,668945,313846,355099,2020
Ciudad de México,50 a 54 años,623483,286394,337089,2020
Ciudad de México,55 a 59 años,526447,239651,286796,2020
Ciudad de México,60 a 64 años,469514,209065,260449,2020
Ciudad de México,65 a 69 años,356196,157245,198951,2020
Ciudad de México,70 a 74 años,267744,115130,152614,2020
Ciudad de México,75 a 79 años,175215,74210,101005,2020
Ciudad de México,80 a 84 años,117480,46094,71386,2020
Ciudad de México,85 a 89 años,66316,24278,42038,2020
Ciudad de México,90 a 94 años,28780,9308,19472,2020
Ciudad de México,95 a 99 años,9066,2725,6341,2020
Ciudad de México,100 años y más,1308,357,951,2020
Ciudad de México,No especificado,9626,4783,4843,2020
Durango,0 a 4 años,167600,85081,82519,2020
Durango,5 a 9 años,176033,89816,86217,2020
Durango,10 a 14 años,170271,86764,83507,2020
Durango,15 a 19 años,162990,82839,80151,2020
Durango,20 a 24 años,153588,76936,76652,2020
Durango,25 a 29 años,141107,69038,72069,2020
Durango,30 a 34 años,129526,63232,66294,2020
Durango,35 a 39 años,118830,57634,61196,2020
Durango,40 a 44 años,114976,55778,59198,2020
Durango,45 a 49 años,108070,52309,55761,2020
Durango,50 a 54 años,97009,45980,51029,2020
Durango,55 a 59 años,79997,37971,42026,2020
Durango,60 a 64 años,66536,31635,34901,2020
Durango,65 a 69 años,49727,23758,25969,2020
Durango,70 a 74 años,36956,17758,19198,2020
Durango,75 a 79 años,25689,12593,13096,2020
Durango,80 a 84 años,17026,8058,8968,2020
Durango,85 a 89 años,9042,4191,4851,2020
Durango,90 a 94 años,3333,1441,1892,2020
Durango,95 a 99 años,1012,418,594,2020
Durango,100 años y más,157,60,97,2020
Durango,No especificado,3175,1576,1599,2020
Guanajuato,0 a 4 años,538846,272745,266101,2020
Guanajuato,5 a 9 años,547545,277429,270116,2020
Guanajuato,10 a 14 años,549301,278676,270625,2020
Guanajuato,15 a 19 años,552092,277977,274115,2020
Guanajuato,20 a 24 años,540587,267148,273439,2020
Guanajuato,25 a 29 años,501868,242026,259842,2020
Guanajuato,30 a 34 años,462332,218363,243969,2020
Guanajuato,35 a 39 años,439045,208278,230767,2020
Guanajuato,40 a 44 años,407230,192549,214681,2020
Guanajuato,45 a 49 años,365660,174419,191241,2020
Guanajuato,50 a 54 años,318197,148310,169887,2020
Guanajuato,55 a 59 años,250808,116934,133874,2020
Guanajuato,60 a 64 años,214406,99483,114923,2020
Guanajuato,65 a 69 años,161765,75898,85867,2020
Guanajuato,70 a 74 años,118285,55393,62892,2020
Guanajuato,75 a 79 años,81110,38242,42868,2020
Guanajuato,80 a 84 años,54366,24455,29911,2020
Guanajuato,85 a 89 años,31747,14089,17658,2020
Guanajuato,90 a 94 años,14003,5815,8188,2020
Guanajuato,95 a 99 años,5009,1992,3017,2020
Guanajuato,100 años y más,683,227,456,2020
Guanajuato,No especificado,12049,6006,6043,2020
Guerrero,0 a 4 años,335458,169332,166126,2020
Guerrero,5 a 9 años,351010,177163,173847,2020
Guerrero,10 a 14 años,348493,176233,172260,2020
Guerrero,15 a 19 años,326540,162620,163920,2020
Guerrero,20 a 24 años,281967,133690,148277,2020
Guerrero,25 a 29 años,256191,118352,137839,2020
Guerrero,30 a 34 años,237976,109644,128332,2020
Guerrero,35 a 39 años,222157,102989,119168,2020
Guerrero,40 a 44 años,209120,97642,111478,2020
Guerrero,45 a 49 años,190778,89571,101207,2020
Guerrero,50 a 54 años,174072,80393,93679,2020
Guerrero,55 a 59 años,148972,69264,79708,2020
Guerrero,60 a 64 años,126765,59295,67470,2020
Guerrero,65 a 69 años,104196,48671,55525,2020
Guerrero,70 a 74 años,77444,36646,40798,2020
Guerrero,75 a 79 años,58071,27472,30599,2020
Guerrero,80 a 84 años,39210,17897,21313,2020
Guerrero,85 a 89 años,23532,10376,13156,2020
Guerrero,90 a 94 años,9187,4039,5148,2020
Guerrero,95 a 99 años,3950,1657,2293,2020
Guerrero,100 años y más,1179,470,709,2020
Guerrero,No especificado,14417,7196,7221,2020
Hidalgo,0 a 4 años,238189,120314,117875,2020
Hidalgo,5 a 9 años,269553,136027,133526,2020
Hidalgo,10 a 14 años,283676,143492,140184,2020
Hidalgo,15 a 19 años,272506,137426,135080,2020
Hidalgo,20 a 24 años,238187,116241,121946,2020
Hidalgo,25 a 29 años,231124,108338,122786,2020
Hidalgo,30 a 34 años,224226,102706,121520,2020
Hidalgo,35 a 39 años,221410,101835,119575,2020
Hidalgo,40 a 44 años,211048,97725,113323,2020
Hidalgo,45 a 49 años,194567,91193,103374,2020
Hidalgo,50 a 54 años,171679,79935,91744,2020
Hidalgo,55 a 59 años,139795,65244,74551,2020
Hidalgo,60 a 64 años,118929,55713,63216,2020
Hidalgo,65 a 69 años,93011,44117,48894,2020
Hidalgo,70 a 74 años,66179,31397,34782,2020
Hidalgo,75 a 79 años,47263,22656,24607,2020
Hidalgo,80 a 84 años,29997,13534,16463,2020
Hidalgo,85 a 89 años,17421,7713,9708,2020
Hidalgo,90 a 94 años,7213,2878,4335,2020
Hidalgo,95 a 99 años,3020,1115,1905,2020
Hidalgo,100 años y más,642,192,450,2020
Hidalgo,No especificado,3206,1588,1618,2020
Jalisco,0 a 4 años,670983,339122,331861,2020
Jalisco,5 a 9 años,718100,363911,354189,2020
Jalisco,10 a 14 años,714906,364020,350886,2020
Jalisco,15 a 19 años,716259,362796,353463,2020
Jalisco,20 a 24 años,704359,351982,352377,2020
Jalisco,25 a 29 años,668334,331070,337264,2020
Jalisco,30 a 34 años,639006,312917,326089,2020
Jalisco,35 a 39 años,602903,295336,307567,2020
Jalisco,40 a 44 años,549859,266310,283549,2020
Jalisco,45 a 49 años,511537,248266,263271,2020
Jalisco,50 a 54 años,444689,210067,234622,2020
Jalisco,55 a 59 años,357080,167535,189545,2020
Jalisco,60 a 64 años,313011,144991,168020,2020
Jalisco,65 a 69 años,240553,111583,128970,2020
Jalisco,70 a 74 años,181420,84464,96956,2020
Jalisco,75 a 79 años,120885,56892,63993,2020
Jalisco,80 a 84 años,76495,33970,42525,2020
Jalisco,85 a 89 años,41507,17843,23664,2020
Jalisco,90 a 94 años,17725,7062,10663,2020
Jalisco,95 a 99 años,6381,2422,3959,2020
Jalisco,100 años y más,1108,393,715,2020
Jalisco,No especificado,51051,25503,25548,2020
México,0 a 4 años,1276386,644777,631609,2020
México,5 a 9 años,1381132,699573,681559,2020
México,10 a 14 años,1464549,740376,724173,2020
México,15 a 19 años,1476665,747531,729134,2020
México,20 a 24 años,1415159,705458,709701,2020
México,25 a 29 años,1367527,667933,699594,2020
México,30 a 34 años,1283264,615018,668246,2020
México,35 a 39 años,1254296,596686,657610,2020
México,40 a 44 años,1197089,563714,633375,2020
México,45 a 49 años,1145882,542558,603324,2020
México,50 a 54 años,1007077,473362,533715,2020
México,55 a 59 años,795711,373977,421734,2020
México,60 a 64 años,661100,307001,354099,2020
México,65 a 69 años,475398,221241,254157,2020
México,70 a 74 años,330905,152248,178657,2020
México,75 a 79 años,212562,97227,115335,2020
México,80 a 84 años,130480,56251,74229,2020
México,85 a 89 años,71307,28844,42463,2020
México,90 a 94 años,26950,9949,17001,2020
México,95 a 99 años,9294,3120,6174,2020
México,100 años y más,1458,424,1034,2020
México,No especificado,8227,4027,4200,2020
Michoacán de Ocampo,0 a 4 años,429837,216825,213012,2020
Michoacán de Ocampo,5 a 9 años,441618,223382,218236,2020
Michoacán de Ocampo,10 a 14 años,426869,215932,210937,2020
Michoacán de Ocampo,15 a 19 años,407743,204821,202922,2020
Michoacán de Ocampo,20 a 24 años,390431,191587,198844,2020
Michoacán de Ocampo,25 a 29 años,367568,176271,191297,2020
Michoacán de Ocampo,30 a 34 años,345272,162946,182326,2020
Michoacán de Ocampo,35 a 39 años,318438,151597,166841,2020
Michoacán de Ocampo,40 a 44 años,299299,142585,156714,2020
Michoacán de Ocampo,45 a 49 años,270544,129380,141164,2020
Michoacán de Ocampo,50 a 54 años,243599,113217,130382,2020
Michoacán de Ocampo,55 a 59 años,202399,94210,108189,2020
Michoacán de Ocampo,60 a 64 años,178844,83238,95606,2020
Michoacán de Ocampo,65 a 69 años,140009,66427,73582,2020
Michoacán de Ocampo,70 a 74 años,106332,50515,55817,2020
Michoacán de Ocampo,75 a 79 años,74938,35694,39244,2020
Michoacán de Ocampo,80 a 84 años,51154,23473,27681,2020
Michoacán de Ocampo,85 a 89 años,30976,13989,16987,2020
Michoacán de Ocampo,90 a 94 años,13255,5868,7387,2020
Michoacán de Ocampo,95 a 99 años,5246,2242,3004,2020
Michoacán de Ocampo,100 años y más,945,396,549,2020
Michoacán de Ocampo,No especificado,3530,1746,1784,2020
Morelos,0 a 4 años,145439,73680,71759,2020
Morelos,5 a 9 años,158935,80637,78298,2020
Morelos,10 a 14 años,164177,83391,80786,2020
Morelos,15 a 19 años,166654,84628,82026,2020
Morelos,20 a 24 años,162146,79566,82580,2020
Morelos,25 a 29 años,154595,74612,79983,2020
Morelos,30 a 34 años,143404,67970,75434,2020
Morelos,35 a 39 años,135994,63749,72245,2020
Morelos,40 a 44 años,130539,60716,69823,2020
Morelos,45 a 49 años,124378,58030,66348,2020
Morelos,50 a 54 años,114284,52588,61696,2020
Morelos,55 a 59 años,96124,44357,51767,2020
Morelos,60 a 64 años,84475,39123,45352,2020
Morelos,65 a 69 años,65650,30758,34892,2020
Morelos,70 a 74 años,47846,22462,25384,2020
Morelos,75 a 79 años,33189,15608,17581,2020
Morelos,80 a 84 años,21954,9791,12163,2020
Morelos,85 a 89 años,13278,5724,7554,2020
Morelos,90 a 94 años,5327,2165,3162,2020
Morelos,95 a 99 años,1844,707,1137,2020
Morelos,100 años y más,340,126,214,2020
Morelos,No especificado,948,459,489,2020
Nayarit,0 a 4 años,103601,52602,50999,2020
Nayarit,5 a 9 años,113942,58000,55942,2020
Nayarit,10 a 14 años,113335,57726,55609,2020
Nayarit,15 a 19 años,104256,52792,51464,2020
Nayarit,20 a 24 años,97500,48537,48963,2020
Nayarit,25 a 29 años,92542,45237,47305,2020
Nayarit,30 a 34 años,90577,43990,46587,2020
Nayarit,35 a 39 años,85180,41559,43621,2020
Nayarit,40 a 44 años,81357,39971,41386,2020
Nayarit,45 a 49 años,75138,37298,37840,2020
Nayarit,50 a 54 años,64958,31691,33267,2020
Nayarit,55 a 59 años,54507,26262,28245,2020
Nayarit,60 a 64 años,47698,22763,24935,2020
Nayarit,65 a 69 años,37876,18563,19313,2020
Nayarit,70 a 74 años,27774,13560,14214,2020
Nayarit,75 a 79 años,19910,9792,10118,2020
Nayarit,80 a 84 años,13039,6345,6694,2020
Nayarit,85 a 89 años,7093,3310,3783,2020
Nayarit,90 a 94 años,2773,1179,1594,2020
Nayarit,95 a 99 años,996,433,563,2020
Nayarit,100 años y más,236,96,140,2020
Nayarit,No especificado,1168,572,596,2020
Nuevo León,0 a 4 años,454909,229807,225102,2020
Nuevo León,5 a 9 años,463819,235679,228140,2020
Nuevo León,10 a 14 años,462720,235404,227316,2020
Nuevo León,15 a 19 años,471896,240241,231655,2020
Nuevo León,20 a 24 años,503826,255533,248293,2020
Nuevo León,25 a 29 años,488349,248479,239870,2020
Nuevo León,30 a 34 años,448470,227051,221419,2020
Nuevo León,35 a 39 años,426619,215999,210620,2020
Nuevo León,40 a 44 años,409490,204944,204546,2020
Nuevo León,45 a 49 años,387678,194154,193524,2020
Nuevo León,50 a 54 años,334439,164492,169947,2020
Nuevo León,55 a 59 años,260045,126971,133074,2020
Nuevo León,60 a 64 años,217238,103697,113541,2020
Nuevo León,65 a 69 años,154408,72766,81642,2020
Nuevo León,70 a 74 años,115822,53640,62182,2020
Nuevo León,75 a 79 años,77327,35523,41804,2020
Nuevo León,80 a 84 años,50350,22069,28281,2020
Nuevo León,85 a 89 años,25023,10300,14723,2020
Nuevo León,90 a 94 años,10365,3903,6462,2020
Nuevo León,95 a 99 años,3097,1133,1964,2020
Nuevo León,100 años y más,420,116,304,2020
Nuevo León,No especificado,18132,9049,9083,2020
Oaxaca,0 a 4 años,359853,181303,178550,2020
Oaxaca,5 a 9 años,388759,195501,193258,2020
Oaxaca,10 a 14 años,398362,201586,196776,2020
Oaxaca,15 a 19 años,358708,178973,179735,2020
Oaxaca,20 a 24 años,310307,147137,163170,2020
Oaxaca,25 a 29 años,307124,141381,165743,2020
Oaxaca,30 a 34 años,289279,132924,156355,2020
Oaxaca,35 a 39 años,276496,127897,148599,2020
Oaxaca,40 a 44 años,259478,120384,139094,2020
Oaxaca,45 a 49 años,233971,108738,125233,2020
Oaxaca,50 a 54 años,210438,96862,113576,2020
Oaxaca,55 a 59 años,179408,83007,96401,2020
Oaxaca,60 a 64 años,155780,72135,83645,2020
Oaxaca,65 a 69 años,127194,58872,68322,2020
Oaxaca,70 a 74 años,93692,43728,49964,2020
Oaxaca,75 a 79 años,73118,34298,38820,2020
Oaxaca,80 a 84 años,50714,23170,27544,2020
Oaxaca,85 a 89 años,31435,14216,17219,2020
Oaxaca,90 a 94 años,12630,5550,7080,2020
Oaxaca,95 a 99 años,4898,2080,2818,2020
Oaxaca,100 años y más,1116,433,683,2020
Oaxaca,No especificado,9388,4668,4720,2020
Puebla,0 a 4 años,578779,292266,286513,2020
Puebla,5 a 9 años,598550,302188,296362,2020
Puebla,10 a 14 años,603375,305853,297522,2020
Puebla,15 a 19 años,607200,305827,301373,2020
Puebla,20 a 24 años,570646,279374,291272,2020
Puebla,25 a 29 años,528289,251899,276390,2020
Puebla,30 a 34 años,475854,221145,254709,2020
Puebla,35 a 39 años,457864,212520,245344,2020
Puebla,40 a 44 años,425089,196550,228539,2020
Puebla,45 a 49 años,382865,178206,204659,2020
Puebla,50 a 54 años,334597,153039,181558,2020
Puebla,55 a 59 años,269080,123605,145475,2020
Puebla,60 a 64 años,229364,104369,124995,2020
Puebla,65 a 69 años,177876,80892,96984,2020
Puebla,70 a 74 años,128374,58004,70370,2020
Puebla,75 a 79 años,91494,41799,49695,2020
Puebla,80 a 84 años,60354,26102,34252,2020
Puebla,85 a 89 años,36491,15340,21151,2020
Puebla,90 a 94 años,14770,5903,8867,2020
Puebla,95 a 99 años,5631,2077,3554,2020
Puebla,100 años y más,1065,335,730,2020
Puebla,No especificado,5671,2822,2849,2020
Querétaro,0 a 4 años,187893,94523,93370,2020
Querétaro,5 a 9 años,196969,99958,97011,2020
Querétaro,10 a 14 años,198601,100847,97754,2020
Querétaro,15 a 19 años,198141,99841,98300,2020
Querétaro,20 a 24 años,209039,104347,104692,2020
Querétaro,25 a 29 años,214139,105543,108596,2020
Querétaro,30 a 34 años,194576,94293,100283,2020
Querétaro,35 a 39 años,182743,87967,94776,2020
Querétaro,40 a 44 años,165728,79318,86410,2020
Querétaro,45 a 49 años,149832,71841,77991,2020
Querétaro,50 a 54 años,125857,59009,66848,2020
Querétaro,55 a 59 años,97903,46132,51771,2020
Querétaro,60 a 64 años,80729,37769,42960,2020
Querétaro,65 a 69 años,57833,26736,31097,2020
Querétaro,70 a 74 años,40979,18799,22180,2020
Querétaro,75 a 79 años,27417,12516,14901,2020
Querétaro,80 a 84 años,17321,7578,9743,2020
Querétaro,85 a 89 años,9975,4174,5801,2020
Querétaro,90 a 94 años,4195,1596,2599,2020
Querétaro,95 a 99 años,1531,557,974,2020
Querétaro,100 años y más,242,76,166,2020
Querétaro,No especificado,6824,3400,3424,2020
Quintana Roo,0 a 4 años,147731,75158,72573,2020
Quintana Roo,5 a 9 años,155388,78621,76767,2020
Quintana Roo,10 a 14 años,154281,78464,75817,2020
Quintana Roo,15 a 19 años,147549,74516,73033,2020
Quintana Roo,20 a 24 años,164989,83186,81803,2020
Quintana Roo,25 a 29 años,184447,93034,91413,2020
Quintana Roo,30 a 34 años,175133,88048,87085,2020
Quintana Roo,35 a 39 años,161472,81665,79807,2020
Quintana Roo,40 a 44 años,136731,68835,67896,2020
Quintana Roo,45 a 49 años,117045,59554,57491,2020
Quintana Roo,50 a 54 años,94160,47616,46544,2020
Quintana Roo,55 a 59 años,66985,33514,33471,2020
Quintana Roo,60 a 64 años,49321,24175,25146,2020
Quintana Roo,65 a 69 años,34204,16738,17466,2020
Quintana Roo,70 a 74 años,21678,10704,10974,2020
Quintana Roo,75 a 79 años,12688,6268,6420,2020
Quintana Roo,80 a 84 años,7421,3570,3851,2020
Quintana Roo,85 a 89 años,3775,1729,2046,2020
Quintana Roo,90 a 94 años,1332,564,768,2020
Quintana Roo,95 a 99 años,531,253,278,2020
Quintana Roo,100 años y más,102,66,36,2020
Quintana Roo,No especificado,21022,10501,10521,2020
San Luis Potosí,0 a 4 años,230931,116331,114600,2020
San Luis Potosí,5 a 9 años,242727,122972,119755,2020
San Luis Potosí,10 a 14 años,252780,128254,124526,2020
San Luis Potosí,15 a 19 años,253797,127984,125813,2020
San Luis Potosí,20 a 24 años,232129,113430,118699,2020
San Luis Potosí,25 a 29 años,220964,106032,114932,2020
San Luis Potosí,30 a 34 años,204288,96754,107534,2020
San Luis Potosí,35 a 39 años,191969,90728,101241,2020
San Luis Potosí,40 a 44 años,180174,85394,94780,2020
San Luis Potosí,45 a 49 años,169453,80668,88785,2020
San Luis Potosí,50 a 54 años,153736,72445,81291,2020
San Luis Potosí,55 a 59 años,125766,59294,66472,2020
San Luis Potosí,60 a 64 años,107635,51031,56604,2020
San Luis Potosí,65 a 69 años,82236,39217,43019,2020
San Luis Potosí,70 a 74 años,63157,30156,33001,2020
San Luis Potosí,75 a 79 años,45985,22290,23695,2020
San Luis Potosí,80 a 84 años,32252,14922,17330,2020
San Luis Potosí,85 a 89 años,18927,8698,10229,2020
San Luis Potosí,90 a 94 años,8052,3502,4550,2020
San Luis Potosí,95 a 99 años,2895,1204,1691,2020
San Luis Potosí,100 años y más,460,181,279,2020
San Luis Potosí,No especificado,1942,964,978,2020
Sinaloa,0 a 4 años,236236,120045,116191,2020
Sinaloa,5 a 9 años,250496,127811,122685,2020
Sinaloa,10 a 14 años,260172,132511,127661,2020
Sinaloa,15 a 19 años,261581,132551,129030,2020
Sinaloa,20 a 24 años,256990,127976,129014,2020
Sinaloa,25 a 29 años,232316,113467,118849,2020
Sinaloa,30 a 34 años,215491,105280,110211,2020
Sinaloa,35 a 39 años,205540,100764,104776,2020
Sinaloa,40 a 44 años,204309,99977,104332,2020
Sinaloa,45 a 49 años,192589,94386,98203,2020
Sinaloa,50 a 54 años,172094,83272,88822,2020
Sinaloa,55 a 59 años,143385,68641,74744,2020
Sinaloa,60 a 64 años,123628,58938,64690,2020
Sinaloa,65 a 69 años,95056,45164,49892,2020
Sinaloa,70 a 74 años,70677,34107,36570,2020
Sinaloa,75 a 79 años,49051,23904,25147,2020
Sinaloa,80 a 84 años,30957,14451,16506,2020
Sinaloa,85 a 89 años,15827,7041,8786,2020
Sinaloa,90 a 94 años,5997,2483,3514,2020
Sinaloa,95 a 99 años,1923,769,1154,2020
Sinaloa,100 años y más,403,169,234,2020
Sinaloa,No especificado,2225,1108,1117,2020
Sonora,0 a 4 años,218345,110604,107741,2020
Sonora,5 a 9 años,246711,125202,121509,2020
Sonora,10 a 14 años,258791,132191,126600,2020
Sonora,15 a 19 años,255716,130755,124961,2020
Sonora,20 a 24 años,247003,125586,121417,2020
Sonora,25 a 29 años,227896,114152,113744,2020
Sonora,30 a 34 años,215004,107455,107549,2020
Sonora,35 a 39 años,207000,103839,103161,2020
Sonora,40 a 44 años,203895,101577,102318,2020
Sonora,45 a 49 años,192181,96274,95907,2020
Sonora,50 a 54 años,170705,84122,86583,2020
Sonora,55 a 59 años,140464,68807,71657,2020
Sonora,60 a 64 años,121603,58841,62762,2020
Sonora,65 a 69 años,87708,42358,45350,2020
Sonora,70 a 74 años,61882,29386,32496,2020
Sonora,75 a 79 años,41519,19677,21842,2020
Sonora,80 a 84 años,26144,11839,14305,2020
Sonora,85 a 89 años,13203,5697,7506,2020
Sonora,90 a 94 años,4727,1849,2878,2020
Sonora,95 a 99 años,1421,539,882,2020
Sonora,100 años y más,197,83,114,2020
Sonora,No especificado,2725,1364,1361,2020
Tabasco,0 a 4 años,206877,104669,102208,2020
Tabasco,5 a 9 años,224058,113706,110352,2020
Tabasco,10 a 14 años,222698,113492,109206,2020
Tabasco,15 a 19 años,208660,105289,103371,2020
Tabasco,20 a 24 años,188555,91925,96630,2020
Tabasco,25 a 29 años,180324,85425,94899,2020
Tabasco,30 a 34 años,181427,85667,95760,2020
Tabasco,35 a 39 años,179476,84231,95245,2020
Tabasco,40 a 44 años,167602,79123,88479,2020
Tabasco,45 a 49 años,147298,70224,77074,2020
Tabasco,50 a 54 años,130575,62842,67733,2020
Tabasco,55 a 59 años,106647,51906,54741,2020
Tabasco,60 a 64 años,84886,41416,43470,2020
Tabasco,65 a 69 años,64809,31582,33227,2020
Tabasco,70 a 74 años,41845,20321,21524,2020
Tabasco,75 a 79 años,29521,14369,15152,2020
Tabasco,80 a 84 años,18674,8952,9722,2020
Tabasco,85 a 89 años,11315,5262,6053,2020
Tabasco,90 a 94 años,4337,1957,2380,2020
Tabasco,95 a 99 años,1677,697,980,2020
Tabasco,100 años y más,461,184,277,2020
Tabasco,No especificado,876,432,444,2020
Tamaulipas,0 a 4 años,271340,137176,134164,2020
Tamaulipas,5 a 9 años,294344,149315,145029,2020
Tamaulipas,10 a 14 años,305853,155866,149987,2020
Tamaulipas,15 a 19 años,294950,149235,145715,2020
Tamaulipas,20 a 24 años,284064,142117,141947,2020
Tamaulipas,25 a 29 años,267261,131093,136168,2020
Tamaulipas,30 a 34 años,256845,125288,131557,2020
Tamaulipas,35 a 39 años,257220,125261,131959,2020
Tamaulipas,40 a 44 años,248637,120639,127998,2020
Tamaulipas,45 a 49 años,236202,115498,120704,2020
Tamaulipas,50 a 54 años,211394,102541,108853,2020
Tamaulipas,55 a 59 años,167744,81176,86568,2020
Tamaulipas,60 a 64 años,139900,66775,73125,2020
Tamaulipas,65 a 69 años,100333,47520,52813,2020
Tamaulipas,70 a 74 años,73616,33955,39661,2020
Tamaulipas,75 a 79 años,50993,23565,27428,2020
Tamaulipas,80 a 84 años,33702,14783,18919,2020
Tamaulipas,85 a 89 años,17930,7663,10267,2020
Tamaulipas,90 a 94 años,7113,2796,4317,2020
Tamaulipas,95 a 99 años,2287,912,1375,2020
Tamaulipas,100 años y más,353,146,207,2020
Tamaulipas,No especificado,5654,2820,2834,2020
Tlaxcala,0 a 4 años,110460,55685,54775,2020
Tlaxcala,5 a 9 años,117738,59685,58053,2020
Tlaxcala,10 a 14 años,119718,60747,58971,2020
Tlaxcala,15 a 19 años,121207,61532,59675,2020
Tlaxcala,20 a 24 años,113937,56738,57199,2020
Tlaxcala,25 a 29 años,104758,50890,53868,2020
Tlaxcala,30 a 34 años,96512,45384,51128,2020
Tlaxcala,35 a 39 años,94896,43586,51310,2020
Tlaxcala,40 a 44 años,89448,41550,47898,2020
Tlaxcala,45 a 49 años,80395,37282,43113,2020
Tlaxcala,50 a 54 años,70782,32540,38242,2020
Tlaxcala,55 a 59 años,56315,26186,30129,2020
Tlaxcala,60 a 64 años,46505,21684,24821,2020
Tlaxcala,65 a 69 años,33958,15919,18039,2020
Tlaxcala,70 a 74 años,24495,11325,13170,2020
Tlaxcala,75 a 79 años,17367,8240,9127,2020
Tlaxcala,80 a 84 años,11591,5335,6256,2020
Tlaxcala,85 a 89 años,7325,3225,4100,2020
Tlaxcala,90 a 94 años,3217,1353,1864,2020
Tlaxcala,95 a 99 años,1231,532,699,2020
Tlaxcala,100 años y más,197,57,140,2020
Tlaxcala,No especificado,20925,10419,10506,2020
Veracruz de Ignacio de la Llave,0 a 4 años,600253,303113,297140,2020
Veracruz de Ignacio de la Llave,5 a 9 años,675182,342335,332847,2020
Veracruz de Ignacio de la Llave,10 a 14 años,685468,347680,337788,2020
Veracruz de Ignacio de la Llave,15 a 19 años,681548,344153,337395,2020
Veracruz de Ignacio de la Llave,20 a 24 años,600394,292359,308035,2020
Veracruz de Ignacio de la Llave,25 a 29 años,580421,272684,307737,2020
Veracruz de Ignacio de la Llave,30 a 34 años,568121,263409,304712,2020
Veracruz de Ignacio de la Llave,35 a 39 años,558791,258605,300186,2020
Veracruz de Ignacio de la Llave,40 a 44 años,537667,247288,290379,2020
Veracruz de Ignacio de la Llave,45 a 49 años,516152,240159,275993,2020
Veracruz de Ignacio de la Llave,50 a 54 años,488510,227672,260838,2020
Veracruz de Ignacio de la Llave,55 a 59 años,408710,192522,216188,2020
Veracruz de Ignacio de la Llave,60 a 64 años,347850,162999,184851,2020
Veracruz de Ignacio de la Llave,65 a 69 años,279233,130731,148502,2020
Veracruz de Ignacio de la Llave,70 a 74 años,203156,95435,107721,2020
Veracruz de Ignacio de la Llave,75 a 79 años,145737,68964,76773,2020
Veracruz de Ignacio de la Llave,80 a 84 años,95232,43082,52150,2020
Veracruz de Ignacio de la Llave,85 a 89 años,54398,23684,30714,2020
Veracruz de Ignacio de la Llave,90 a 94 años,21825,9066,12759,2020
Veracruz de Ignacio de la Llave,95 a 99 años,8304,3328,4976,2020
Veracruz de Ignacio de la Llave,100 años y más,2157,799,1358,2020
Veracruz de Ignacio de la Llave,No especificado,3470,1707,1763,2020
Yucatán,0 a 4 años,175986,89335,86651,2020
Yucatán,5 a 9 años,186122,93902,92220,2020
Yucatán,10 a 14 años,189137,95833,93304,2020
Yucatán,15 a 19 años,196363,99417,96946,2020
Yucatán,20 a 24 años,199525,100085,99440,2020
Yucatán,25 a 29 años,190975,94526,96449,2020
Yucatán,30 a 34 años,183035,89203,93832,2020
Yucatán,35 a 39 años,174099,84877,89222,2020
Yucatán,40 a 44 años,161231,77759,83472,2020
Yucatán,45 a 49 años,146033,70247,75786,2020
Yucatán,50 a 54 años,122358,57886,64472,2020
Yucatán,55 a 59 años,103183,48826,54357,2020
Yucatán,60 a 64 años,86773,40883,45890,2020
Yucatán,65 a 69 años,72318,34270,38048,2020
Yucatán,70 a 74 años,53224,25378,27846,2020
Yucatán,75 a 79 años,35612,17163,18449,2020
Yucatán,80 a 84 años,22476,10519,11957,2020
Yucatán,85 a 89 años,12224,5530,6694,2020
Yucatán,90 a 94 años,4647,2023,2624,2020
Yucatán,95 a 99 años,1556,640,916,2020
Yucatán,100 años y más,205,81,124,2020
Yucatán,No especificado,3816,1896,1920,2020
Zacatecas,0 a 4 años,151745,76563,75182,2020
Zacatecas,5 a 9 años,155704,78441,77263,2020
Zacatecas,10 a 14 años,151355,76912,74443,2020
Zacatecas,15 a 19 años,141208,70860,70348,2020
Zacatecas,20 a 24 años,130238,63289,66949,2020
Zacatecas,25 a 29 años,117673,55905,61768,2020
Zacatecas,30 a 34 años,114442,53586,60856,2020
Zacatecas,35 a 39 años,104728,49653,55075,2020
Zacatecas,40 a 44 años,102682,48739,53943,2020
Zacatecas,45 a 49 años,95118,46099,49019,2020
Zacatecas,50 a 54 años,86207,40965,45242,2020
Zacatecas,55 a 59 años,69401,32945,36456,2020
Zacatecas,60 a 64 años,58039,27708,30331,2020
Zacatecas,65 a 69 años,44719,21507,23212,2020
Zacatecas,70 a 74 años,35100,17080,18020,2020
Zacatecas,75 a 79 años,26357,13015,13342,2020
Zacatecas,80 a 84 años,18058,8641,9417,2020
Zacatecas,85 a 89 años,10975,5233,5742,2020
Zacatecas,90 a 94 años,4569,2160,2409,2020
Zacatecas,95 a 99 años,1723,738,985,2020
Zacatecas,100 años y más,239,102,137,2020
Zacatecas,No especificado,1858,917,941,2020
